match_year,match_round,team,team_rank,team_points,team_goal_difference,team_goal_fatti,team_goal_subiti
2009,2,Arsenal,1,3,5,6,1
2009,2,West Ham,2,3,2,2,0
2009,2,Man City,3,3,2,2,0
2009,2,Wigan,4,3,2,2,0
2009,2,Stoke City,5,3,2,2,0
2009,2,Chelsea,6,3,1,2,1
2009,2,Spurs,7,3,1,2,1
2009,2,Man Utd,8,3,1,1,0
2009,2,Fulham,9,3,1,1,0
2009,2,Sunderland,10,3,1,1,0
2009,2,Liverpool,11,0,-1,1,2
2009,2,Hull City,12,0,-1,1,2
2009,2,Bolton,13,0,-1,0,1
2009,2,Birmingham,14,0,-1,0,1
2009,2,Aston Villa,15,0,-2,0,2
2009,2,Blackburn,16,0,-2,0,2
2009,2,Wolves,17,0,-2,0,2
2009,2,Burnley,18,0,-2,0,2
2009,2,Everton,19,0,-5,1,6
2009,2,Portsmouth,20,-9,-1,0,1
2009,3,Arsenal,1,6,7,10,3
2009,3,Spurs,2,6,5,7,2
2009,3,Fulham,3,6,4,4,0
2009,3,Chelsea,4,6,3,5,2
2009,3,West Ham,5,6,3,4,1
2009,3,Liverpool,6,3,3,5,2
2009,3,Wigan,7,3,1,2,1
2009,3,Man City,8,3,0,2,2
2009,3,Man Utd,9,3,0,1,1
2009,3,Birmingham,10,3,0,1,1
2009,3,Sunderland,11,3,-1,2,3
2009,3,Wolves,12,3,-1,1,2
2009,3,Burnley,13,3,-1,1,2
2009,3,Stoke City,14,3,-2,2,4
2009,3,Everton,15,3,-3,3,6
2009,3,Bolton,16,0,-3,2,5
2009,3,Aston Villa,17,0,-3,1,4
2009,3,Hull City,18,0,-5,2,7
2009,3,Blackburn,19,0,-5,0,5
2009,3,Portsmouth,20,-9,-2,0,2
2009,4,Arsenal,1,9,10,14,4
2009,4,Spurs,2,9,6,9,3
2009,4,Chelsea,3,9,5,7,2
2009,4,Man Utd,4,6,5,6,1
2009,4,West Ham,5,6,2,5,3
2009,4,Fulham,6,6,2,4,2
2009,4,Man City,7,6,1,3,2
2009,4,Sunderland,8,6,0,4,4
2009,4,Burnley,9,6,0,2,2
2009,4,Birmingham,10,4,0,1,1
2009,4,Stoke City,11,4,-2,2,4
2009,4,Liverpool,12,3,1,6,5
2009,4,Aston Villa,13,3,-1,4,5
2009,4,Wolves,14,3,-2,1,3
2009,4,Everton,15,3,-4,3,7
2009,4,Hull City,16,3,-4,3,7
2009,4,Wigan,17,3,-4,2,6
2009,4,Bolton,18,0,-4,2,6
2009,4,Blackburn,19,0,-6,1,7
2009,4,Portsmouth,20,-9,-5,1,6
2009,5,Chelsea,1,12,8,10,2
2009,5,Spurs,2,12,7,11,4
2009,5,Arsenal,3,9,9,15,6
2009,5,Man Utd,4,9,6,8,2
2009,5,Man City,5,9,2,4,2
2009,5,West Ham,6,7,2,5,3
2009,5,Stoke City,7,7,-1,3,4
2009,5,Liverpool,8,6,2,9,7
2009,5,Aston Villa,9,6,1,6,5
2009,5,Fulham,10,6,0,4,4
2009,5,Sunderland,11,6,-1,4,5
2009,5,Everton,12,6,-3,5,8
2009,5,Burnley,13,6,-3,2,5
2009,5,Birmingham,14,4,-1,2,3
2009,5,Wolves,15,4,-2,2,4
2009,5,Hull City,16,4,-4,4,8
2009,5,Wigan,17,3,-5,3,8
2009,5,Blackburn,18,1,-6,1,7
2009,5,Bolton,19,0,-5,4,9
2009,5,Portsmouth,20,-9,-6,1,7
2009,6,Chelsea,1,15,9,12,3
2009,6,Man Utd,2,12,8,11,3
2009,6,Spurs,3,12,5,12,7
2009,6,Man City,4,12,4,8,4
2009,6,Arsenal,5,9,7,17,10
2009,6,Liverpool,6,9,6,13,7
2009,6,Sunderland,7,9,2,8,6
2009,6,Aston Villa,8,9,2,7,5
2009,6,Fulham,9,9,1,6,5
2009,6,West Ham,10,7,1,5,4
2009,6,Stoke City,11,7,-2,4,6
2009,6,Everton,12,6,-4,6,10
2009,6,Wigan,13,6,-4,4,8
2009,6,Burnley,14,6,-7,2,9
2009,6,Birmingham,15,4,-2,2,4
2009,6,Blackburn,16,4,-4,4,8
2009,6,Wolves,17,4,-4,3,7
2009,6,Hull City,18,4,-7,5,12
2009,6,Bolton,19,3,-4,7,11
2009,6,Portsmouth,20,-9,-7,3,10
2009,7,Chelsea,1,18,12,15,3
2009,7,Man Utd,2,15,9,15,6
2009,7,Arsenal,3,12,11,21,10
2009,7,Liverpool,4,12,7,16,9
2009,7,Aston Villa,5,12,4,9,5
2009,7,Man City,6,12,3,11,8
2009,7,Spurs,7,12,2,12,10
2009,7,Sunderland,8,9,0,9,9
2009,7,Fulham,9,9,0,7,7
2009,7,Everton,10,9,-1,9,10
2009,7,Burnley,11,9,-5,5,10
2009,7,Stoke City,12,8,-2,5,7
2009,7,West Ham,13,7,0,7,7
2009,7,Birmingham,14,7,-1,3,4
2009,7,Wolves,15,7,-3,5,8
2009,7,Wigan,16,6,-8,4,12
2009,7,Bolton,17,4,-4,8,12
2009,7,Blackburn,18,4,-7,4,11
2009,7,Hull City,19,4,-8,5,13
2009,7,Portsmouth,20,-9,-9,3,12
2009,8,Man Utd,1,18,11,17,6
2009,8,Chelsea,2,18,10,16,6
2009,8,Liverpool,3,15,12,22,10
2009,8,Arsenal,4,15,12,22,10
2009,8,Spurs,5,15,7,17,10
2009,8,Man City,6,15,5,14,9
2009,8,Sunderland,7,12,3,14,11
2009,8,Aston Villa,8,12,3,10,7
2009,8,Everton,9,12,0,10,10
2009,8,Fulham,10,9,-1,7,8
2009,8,Wigan,11,9,-6,7,13
2009,8,Burnley,12,9,-10,5,15
2009,8,Stoke City,13,8,-4,5,9
2009,8,West Ham,14,7,-2,8,10
2009,8,Birmingham,15,7,-2,4,6
2009,8,Bolton,16,7,-3,10,13
2009,8,Wolves,17,7,-6,7,13
2009,8,Blackburn,18,7,-6,6,12
2009,8,Hull City,19,4,-13,6,19
2009,8,Portsmouth,20,-9,-10,3,13
2009,9,Chelsea,1,21,12,18,6
2009,9,Man Utd,2,19,11,19,8
2009,9,Arsenal,3,18,16,28,12
2009,9,Spurs,4,16,7,19,12
2009,9,Man City,5,16,5,15,10
2009,9,Liverpool,6,15,10,22,12
2009,9,Sunderland,7,13,3,16,13
2009,9,Aston Villa,8,13,3,11,8
2009,9,Everton,9,13,0,11,11
2009,9,Burnley,10,12,-9,7,16
2009,9,Fulham,11,10,-1,9,10
2009,9,Stoke City,12,9,-4,6,10
2009,9,Wigan,13,9,-7,8,15
2009,9,West Ham,14,8,-2,10,12
2009,9,Bolton,15,8,-3,12,15
2009,9,Birmingham,16,7,-3,5,8
2009,9,Wolves,17,7,-7,7,14
2009,9,Blackburn,18,7,-10,8,18
2009,9,Hull City,19,7,-12,8,20
2009,9,Portsmouth,20,-6,-9,4,13
2009,10,Man Utd,1,22,12,21,9
2009,10,Arsenal,2,21,18,31,13
2009,10,Chelsea,3,21,11,19,8
2009,10,Spurs,4,19,8,21,13
2009,10,Man City,5,17,5,16,11
2009,10,Sunderland,6,16,4,17,13
2009,10,Aston Villa,7,16,4,13,9
2009,10,Liverpool,8,15,9,22,13
2009,10,Everton,9,14,0,12,12
2009,10,Fulham,10,13,1,11,10
2009,10,Stoke City,11,12,-3,8,11
2009,10,Burnley,12,12,-10,9,19
2009,10,Wigan,13,10,-7,9,16
2009,10,Blackburn,14,10,-9,11,20
2009,10,West Ham,15,8,-3,11,14
2009,10,Bolton,16,8,-4,13,17
2009,10,Wolves,17,8,-7,8,15
2009,10,Birmingham,18,7,-5,6,11
2009,10,Hull City,19,7,-14,8,22
2009,10,Portsmouth,20,-6,-10,5,15
2009,11,Chelsea,1,24,16,24,8
2009,11,Arsenal,2,22,18,33,15
2009,11,Man Utd,3,22,10,21,11
2009,11,Spurs,4,19,7,21,14
2009,11,Liverpool,5,18,11,24,13
2009,11,Man City,6,18,5,18,13
2009,11,Aston Villa,7,17,4,14,10
2009,11,Sunderland,8,16,3,18,15
2009,11,Stoke City,9,15,-2,9,11
2009,11,Fulham,10,14,1,13,12
2009,11,Everton,11,14,-1,14,15
2009,11,Wigan,12,13,-5,12,17
2009,11,Burnley,13,12,-12,10,22
2009,11,Bolton,14,11,-3,16,19
2009,11,Birmingham,15,10,-4,8,12
2009,11,Blackburn,16,10,-14,11,25
2009,11,West Ham,17,9,-3,13,16
2009,11,Wolves,18,9,-7,9,16
2009,11,Hull City,19,8,-14,8,22
2009,11,Portsmouth,20,-5,-10,5,15
2009,12,Chelsea,1,27,20,28,8
2009,12,Arsenal,2,25,21,36,15
2009,12,Man Utd,3,25,12,23,11
2009,12,Man City,4,19,5,18,13
2009,12,Spurs,5,19,4,21,17
2009,12,Liverpool,6,18,9,25,16
2009,12,Aston Villa,7,18,4,15,11
2009,12,Sunderland,8,17,3,20,17
2009,12,Fulham,9,17,3,16,13
2009,12,Stoke City,10,16,-2,11,13
2009,12,Everton,11,15,-1,15,16
2009,12,Burnley,12,15,-10,12,22
2009,12,Wigan,13,13,-9,12,21
2009,12,Birmingham,14,11,-4,8,12
2009,12,Bolton,15,11,-7,16,23
2009,12,West Ham,16,10,-3,15,18
2009,12,Wolves,17,10,-7,11,18
2009,12,Blackburn,18,10,-16,11,27
2009,12,Hull City,19,8,-16,8,24
2009,12,Portsmouth,20,-2,-6,9,15
2009,13,Chelsea,1,30,21,29,8
2009,13,Arsenal,2,28,24,40,16
2009,13,Man Utd,3,25,11,23,12
2009,13,Spurs,4,22,6,23,17
2009,13,Aston Villa,5,21,8,20,12
2009,13,Man City,6,20,5,21,16
2009,13,Liverpool,7,19,9,27,18
2009,13,Fulham,8,18,3,17,14
2009,13,Everton,9,18,0,17,17
2009,13,Sunderland,10,17,1,20,19
2009,13,Stoke City,11,16,-3,12,15
2009,13,Burnley,12,16,-10,15,25
2009,13,Wigan,13,14,-9,13,22
2009,13,Blackburn,14,13,-14,14,28
2009,13,Birmingham,15,12,-4,10,14
2009,13,Bolton,16,11,-11,17,28
2009,13,Hull City,17,11,-15,10,25
2009,13,West Ham,18,10,-4,16,20
2009,13,Wolves,19,10,-10,12,22
2009,13,Portsmouth,20,-2,-8,10,18
2009,14,Chelsea,1,33,25,33,8
2009,14,Arsenal,2,28,23,40,17
2009,14,Man Utd,3,28,14,26,12
2009,14,Spurs,4,25,14,32,18
2009,14,Aston Villa,5,22,8,21,13
2009,14,Man City,6,21,5,23,18
2009,14,Liverpool,7,20,9,29,20
2009,14,Sunderland,8,20,2,21,19
2009,14,Stoke City,9,19,-2,13,15
2009,14,Fulham,10,18,2,17,15
2009,14,Everton,11,18,-3,17,20
2009,14,Burnley,12,17,-10,16,26
2009,14,Blackburn,13,16,-12,16,28
2009,14,Birmingham,14,15,-3,11,14
2009,14,Wigan,15,14,-17,14,31
2009,14,Hull City,16,12,-15,13,28
2009,14,West Ham,17,11,-4,19,23
2009,14,Bolton,18,11,-13,17,30
2009,14,Wolves,19,10,-14,12,26
2009,14,Portsmouth,20,-2,-9,10,19
2009,15,Chelsea,1,36,28,36,8
2009,15,Man Utd,2,31,17,30,13
2009,15,Arsenal,3,28,20,40,20
2009,15,Spurs,4,26,14,33,19
2009,15,Liverpool,5,23,11,31,20
2009,15,Aston Villa,6,23,8,22,14
2009,15,Man City,7,22,5,24,19
2009,15,Sunderland,8,20,1,21,20
2009,15,Stoke City,9,20,-2,13,15
2009,15,Fulham,10,19,2,18,16
2009,15,Birmingham,11,18,-2,12,14
2009,15,Everton,12,18,-5,17,22
2009,15,Burnley,13,17,-12,19,31
2009,15,Blackburn,14,17,-12,16,28
2009,15,Wigan,15,17,-16,15,31
2009,15,West Ham,16,14,-2,24,26
2009,15,Hull City,17,13,-15,14,29
2009,15,Bolton,18,12,-13,18,31
2009,15,Wolves,19,10,-15,12,27
2009,15,Portsmouth,20,-2,-12,11,23
2009,16,Chelsea,1,36,27,37,10
2009,16,Man Utd,2,34,21,34,13
2009,16,Arsenal,3,31,22,42,20
2009,16,Spurs,4,27,14,35,21
2009,16,Aston Villa,5,26,11,25,14
2009,16,Man City,6,25,6,26,20
2009,16,Liverpool,7,24,11,31,20
2009,16,Fulham,8,22,3,19,16
2009,16,Birmingham,9,21,-1,15,16
2009,16,Sunderland,10,20,0,21,21
2009,16,Stoke City,11,20,-4,13,17
2009,16,Everton,12,19,-5,19,24
2009,16,Blackburn,13,18,-12,16,28
2009,16,Burnley,14,17,-14,19,33
2009,16,Wigan,15,17,-17,17,34
2009,16,West Ham,16,14,-6,24,30
2009,16,Wolves,17,13,-14,14,28
2009,16,Hull City,18,13,-18,14,32
2009,16,Bolton,19,12,-14,19,33
2009,16,Portsmouth,20,1,-10,13,23
2009,17,Chelsea,1,37,27,40,13
2009,17,Arsenal,2,34,23,44,21
2009,17,Man Utd,3,34,20,34,14
2009,17,Aston Villa,4,29,12,26,14
2009,17,Spurs,5,27,13,35,22
2009,17,Man City,6,26,6,29,23
2009,17,Liverpool,7,24,10,32,22
2009,17,Birmingham,8,24,0,16,16
2009,17,Fulham,9,23,3,20,17
2009,17,Sunderland,10,21,0,22,22
2009,17,Stoke City,11,21,-4,15,19
2009,17,Everton,12,20,-5,22,27
2009,17,Blackburn,13,19,-12,16,28
2009,17,Burnley,14,18,-14,20,34
2009,17,Wigan,15,18,-17,19,36
2009,17,Wolves,16,16,-13,15,28
2009,17,West Ham,17,14,-7,24,31
2009,17,Hull City,18,14,-18,14,32
2009,17,Bolton,19,13,-14,22,36
2009,17,Portsmouth,20,2,-10,14,24
2009,18,Chelsea,1,40,28,42,14
2009,18,Man Utd,2,37,23,37,14
2009,18,Arsenal,3,35,23,45,22
2009,18,Aston Villa,4,32,14,28,14
2009,18,Spurs,5,30,16,38,22
2009,18,Liverpool,6,27,11,34,23
2009,18,Birmingham,7,27,1,18,17
2009,18,Man City,8,26,3,29,26
2009,18,Stoke City,9,24,-3,18,21
2009,18,Fulham,10,23,2,22,20
2009,18,Sunderland,11,21,-2,22,24
2009,18,Everton,12,20,-6,24,30
2009,18,Blackburn,13,19,-13,17,30
2009,18,Burnley,14,19,-14,21,35
2009,18,Wigan,15,18,-18,20,38
2009,18,Hull City,16,17,-17,17,34
2009,18,Bolton,17,16,-12,25,37
2009,18,Wolves,18,16,-16,15,31
2009,18,West Ham,19,14,-9,25,34
2009,18,Portsmouth,20,2,-11,15,26
2009,19,Chelsea,1,41,28,43,15
2009,19,Arsenal,2,38,26,48,22
2009,19,Man Utd,3,37,20,37,17
2009,19,Aston Villa,4,35,15,29,14
2009,19,Spurs,5,33,18,40,22
2009,19,Man City,6,29,4,33,29
2009,19,Birmingham,7,28,1,19,18
2009,19,Liverpool,8,27,9,34,25
2009,19,Fulham,9,26,5,25,20
2009,19,Stoke City,10,24,-4,18,22
2009,19,Sunderland,11,21,-3,25,28
2009,19,Everton,12,21,-6,25,31
2009,19,Wolves,13,19,-14,17,31
2009,19,Blackburn,14,19,-15,17,32
2009,19,Burnley,15,19,-16,21,37
2009,19,Wigan,16,19,-18,20,38
2009,19,Bolton,17,17,-12,25,37
2009,19,Hull City,18,17,-20,17,37
2009,19,West Ham,19,15,-9,26,35
2009,19,Portsmouth,20,5,-9,17,26
2009,20,Chelsea,1,42,28,43,15
2009,20,Arsenal,2,41,29,51,22
2009,20,Man Utd,3,40,22,40,18
2009,20,Aston Villa,4,35,12,29,17
2009,20,Spurs,5,34,18,40,22
2009,20,Man City,6,32,6,35,29
2009,20,Liverpool,7,30,11,36,25
2009,20,Birmingham,8,29,1,19,18
2009,20,Fulham,9,27,5,25,20
2009,20,Stoke City,10,24,-6,18,24
2009,20,Sunderland,11,22,-3,26,29
2009,20,Everton,12,22,-6,26,32
2009,20,Blackburn,13,20,-15,18,33
2009,20,Burnley,14,20,-16,22,38
2009,20,Wigan,15,20,-18,21,39
2009,20,Wolves,16,19,-16,17,33
2009,20,West Ham,17,18,-7,28,35
2009,20,Bolton,18,18,-12,26,38
2009,20,Hull City,19,17,-22,18,40
2009,20,Portsmouth,20,5,-11,17,28
2009,21,Chelsea,1,45,29,45,16
2009,21,Arsenal,2,44,32,55,23
2009,21,Man Utd,3,43,27,45,18
2009,21,Spurs,4,37,20,42,22
2009,21,Aston Villa,5,35,11,29,18
2009,21,Man City,6,35,9,38,29
2009,21,Liverpool,7,33,12,37,25
2009,21,Birmingham,8,32,2,20,18
2009,21,Fulham,9,27,4,26,22
2009,21,Everton,10,25,-4,28,32
2009,21,Stoke City,11,24,-7,18,25
2009,21,Sunderland,12,23,-3,28,31
2009,21,Blackburn,13,21,-15,20,35
2009,21,Burnley,14,20,-18,22,40
2009,21,Wigan,15,20,-23,21,44
2009,21,Bolton,16,19,-12,28,40
2009,21,Wolves,17,19,-19,17,36
2009,21,West Ham,18,18,-9,28,37
2009,21,Hull City,19,18,-22,20,42
2009,21,Portsmouth,20,5,-14,18,32
2009,22,Chelsea,1,46,29,46,17
2009,22,Arsenal,2,45,32,57,25
2009,22,Man Utd,3,44,27,46,19
2009,22,Man City,4,38,12,42,30
2009,22,Aston Villa,5,38,12,31,19
2009,22,Spurs,6,37,18,42,24
2009,22,Liverpool,7,36,14,39,25
2009,22,Birmingham,8,33,2,21,19
2009,22,Fulham,9,30,5,27,22
2009,22,Sunderland,10,26,1,32,31
2009,22,Everton,11,26,-4,30,34
2009,22,Stoke City,12,25,-7,19,26
2009,22,Wolves,13,22,-17,20,37
2009,22,Burnley,14,21,-18,23,41
2009,22,Blackburn,15,21,-18,21,39
2009,22,Wigan,16,20,-24,22,46
2009,22,Bolton,17,19,-16,28,44
2009,22,Hull City,18,19,-22,21,43
2009,22,West Ham,19,18,-11,29,40
2009,22,Portsmouth,20,5,-15,18,33
2009,23,Chelsea,1,49,34,53,19
2009,23,Arsenal,2,48,34,59,25
2009,23,Man Utd,3,47,30,49,19
2009,23,Aston Villa,4,39,12,31,19
2009,23,Spurs,5,38,18,42,24
2009,23,Man City,6,38,10,42,32
2009,23,Liverpool,7,37,14,40,26
2009,23,Birmingham,8,36,3,23,20
2009,23,Fulham,9,30,3,27,24
2009,23,Everton,10,29,-2,32,34
2009,23,Sunderland,11,26,-4,34,38
2009,23,Stoke City,12,26,-7,20,27
2009,23,Blackburn,13,24,-16,23,39
2009,23,Wigan,14,23,-22,24,46
2009,23,Wolves,15,22,-19,20,39
2009,23,Burnley,16,21,-21,23,44
2009,23,Hull City,17,20,-22,21,43
2009,23,West Ham,18,19,-11,29,40
2009,23,Bolton,19,19,-18,28,46
2009,23,Portsmouth,20,5,-16,19,35
2009,24,Chelsea,1,52,37,56,19
2009,24,Man Utd,2,50,34,53,19
2009,24,Arsenal,3,49,34,59,25
2009,24,Spurs,4,41,20,44,24
2009,24,Aston Villa,5,40,12,31,19
2009,24,Man City,6,39,10,43,33
2009,24,Liverpool,7,38,14,40,26
2009,24,Birmingham,8,36,0,23,23
2009,24,Everton,9,32,0,34,34
2009,24,Fulham,10,30,1,27,26
2009,24,Stoke City,11,27,-7,21,28
2009,24,Blackburn,12,27,-15,25,40
2009,24,Sunderland,13,26,-6,34,40
2009,24,Wolves,14,23,-19,20,39
2009,24,Wigan,15,23,-23,25,48
2009,24,Bolton,16,22,-17,29,46
2009,24,Burnley,17,21,-22,23,45
2009,24,West Ham,18,20,-11,30,41
2009,24,Hull City,19,20,-26,21,47
2009,24,Portsmouth,20,6,-16,20,36
2009,25,Chelsea,1,55,38,58,20
2009,25,Man Utd,2,53,36,56,20
2009,25,Arsenal,3,49,32,60,28
2009,25,Aston Villa,4,43,14,33,19
2009,25,Spurs,5,42,20,45,25
2009,25,Man City,6,42,12,45,33
2009,25,Liverpool,7,41,16,42,26
2009,25,Birmingham,8,37,0,24,24
2009,25,Everton,9,35,1,35,34
2009,25,Fulham,10,30,-1,27,28
2009,25,Stoke City,11,28,-7,21,28
2009,25,Blackburn,12,28,-15,25,40
2009,25,Sunderland,13,27,-6,34,40
2009,25,Wolves,14,24,-19,22,41
2009,25,Wigan,15,23,-24,25,49
2009,25,Bolton,16,22,-19,29,48
2009,25,West Ham,17,21,-11,30,41
2009,25,Burnley,18,21,-23,24,47
2009,25,Hull City,19,21,-26,23,49
2009,25,Portsmouth,20,6,-18,20,38
2009,26,Chelsea,1,58,40,60,20
2009,26,Man Utd,2,56,41,61,20
2009,26,Arsenal,3,49,30,60,30
2009,26,Liverpool,4,44,17,43,26
2009,26,Aston Villa,5,44,14,33,19
2009,26,Spurs,6,43,20,45,25
2009,26,Man City,7,42,11,46,35
2009,26,Birmingham,8,40,1,26,25
2009,26,Everton,9,35,0,35,35
2009,26,Fulham,10,31,-1,27,28
2009,26,Stoke City,11,31,-4,24,28
2009,26,Sunderland,12,28,-6,35,41
2009,26,Blackburn,13,28,-18,25,43
2009,26,Wolves,14,24,-20,23,43
2009,26,Burnley,15,24,-22,26,48
2009,26,Wigan,16,24,-24,26,50
2009,26,Hull City,17,24,-25,25,50
2009,26,Bolton,18,23,-19,29,48
2009,26,West Ham,19,21,-12,31,43
2009,26,Portsmouth,20,6,-23,20,43
2009,27,Chelsea,1,58,39,61,22
2009,27,Man Utd,2,57,41,62,21
2009,27,Arsenal,3,52,31,61,30
2009,27,Aston Villa,4,45,14,34,20
2009,27,Man City,5,45,13,48,35
2009,27,Liverpool,6,44,16,43,27
2009,27,Spurs,7,43,19,45,26
2009,27,Birmingham,8,40,-1,26,27
2009,27,Everton,9,38,1,37,36
2009,27,Fulham,10,34,2,30,28
2009,27,Stoke City,11,32,-4,25,29
2009,27,Blackburn,12,31,-17,26,43
2009,27,Sunderland,13,29,-6,36,42
2009,27,Wolves,14,27,-19,24,43
2009,27,Wigan,15,25,-24,27,51
2009,27,West Ham,16,24,-10,33,43
2009,27,Burnley,17,24,-25,26,51
2009,27,Hull City,18,24,-26,25,51
2009,27,Bolton,19,23,-21,29,50
2009,27,Portsmouth,20,7,-23,21,44
2009,28,Chelsea,1,61,41,63,22
2009,28,Man Utd,2,57,39,63,24
2009,28,Arsenal,3,55,33,63,30
2009,28,Aston Villa,4,48,17,39,22
2009,28,Spurs,5,46,22,48,26
2009,28,Man City,6,46,13,48,35
2009,28,Liverpool,7,45,16,43,27
2009,28,Everton,8,41,3,40,37
2009,28,Birmingham,9,40,-2,27,29
2009,28,Fulham,10,37,3,32,29
2009,28,Stoke City,11,35,-3,27,30
2009,28,Blackburn,12,34,-14,29,43
2009,28,Sunderland,13,29,-8,36,44
2009,28,West Ham,14,27,-7,36,43
2009,28,Wolves,15,27,-21,24,45
2009,28,Wigan,16,25,-27,27,54
2009,28,Burnley,17,24,-28,28,56
2009,28,Hull City,18,24,-29,25,54
2009,28,Bolton,19,23,-24,29,53
2009,28,Portsmouth,20,7,-24,22,46
2009,29,Chelsea,1,61,39,65,26
2009,29,Man Utd,2,60,42,66,24
2009,29,Arsenal,3,58,35,66,31
2009,29,Aston Villa,4,51,19,41,22
2009,29,Spurs,5,49,23,50,27
2009,29,Man City,6,49,15,52,37
2009,29,Liverpool,7,48,17,45,28
2009,29,Birmingham,8,43,-1,28,29
2009,29,Everton,9,41,2,41,39
2009,29,Fulham,10,38,3,32,29
2009,29,Stoke City,11,35,-5,28,33
2009,29,Blackburn,12,34,-15,30,45
2009,29,Sunderland,13,30,-8,36,44
2009,29,West Ham,14,27,-10,36,46
2009,29,Wolves,15,27,-22,24,46
2009,29,Bolton,16,26,-23,30,53
2009,29,Wigan,17,25,-28,27,55
2009,29,Burnley,18,24,-29,29,58
2009,29,Hull City,19,24,-31,25,56
2009,29,Portsmouth,20,10,-23,24,47
2009,30,Chelsea,1,64,44,70,26
2009,30,Man Utd,2,63,43,67,24
2009,30,Arsenal,3,61,37,69,32
2009,30,Spurs,4,52,24,51,27
2009,30,Aston Villa,5,52,19,42,23
2009,30,Man City,6,49,14,52,38
2009,30,Liverpool,7,48,16,45,29
2009,30,Everton,8,44,6,46,40
2009,30,Birmingham,9,43,-2,29,31
2009,30,Fulham,10,38,2,32,30
2009,30,Stoke City,11,38,-4,29,33
2009,30,Blackburn,12,37,-14,32,46
2009,30,Sunderland,13,31,-8,37,45
2009,30,Bolton,14,29,-22,32,54
2009,30,Wigan,15,28,-27,28,55
2009,30,West Ham,16,27,-11,37,48
2009,30,Wolves,17,27,-23,24,47
2009,30,Burnley,18,24,-31,30,61
2009,30,Hull City,19,24,-35,26,61
2009,30,Portsmouth,20,10,-28,24,52
2009,31,Chelsea,1,67,47,74,27
2009,31,Man Utd,2,66,46,70,24
2009,31,Arsenal,3,64,38,71,33
2009,31,Spurs,4,55,26,54,28
2009,31,Aston Villa,5,53,19,42,23
2009,31,Liverpool,6,51,19,49,30
2009,31,Man City,7,50,14,53,39
2009,31,Everton,8,45,6,48,42
2009,31,Birmingham,9,44,-2,31,33
2009,31,Stoke City,10,39,-4,29,33
2009,31,Fulham,11,38,-1,32,33
2009,31,Blackburn,12,37,-16,33,49
2009,31,Sunderland,13,32,-8,38,46
2009,31,Bolton,14,32,-18,36,54
2009,31,Wolves,15,30,-22,26,48
2009,31,Wigan,16,28,-31,28,59
2009,31,West Ham,17,27,-14,38,52
2009,31,Burnley,18,24,-32,31,63
2009,31,Hull City,19,24,-36,27,63
2009,31,Portsmouth,20,10,-31,25,56
2009,32,Man Utd,1,69,47,72,25
2009,32,Chelsea,2,68,47,75,28
2009,32,Arsenal,3,67,40,73,33
2009,32,Spurs,4,58,27,56,29
2009,32,Aston Villa,5,54,19,44,25
2009,32,Man City,6,53,15,55,40
2009,32,Liverpool,7,51,18,50,32
2009,32,Everton,8,48,8,50,42
2009,32,Birmingham,9,44,-4,32,36
2009,32,Stoke City,10,39,-5,30,35
2009,32,Fulham,11,38,-2,33,35
2009,32,Blackburn,12,38,-16,34,50
2009,32,Sunderland,13,35,-6,41,47
2009,32,Bolton,14,32,-20,36,56
2009,32,Wolves,15,31,-22,28,50
2009,32,Wigan,16,31,-30,29,59
2009,32,West Ham,17,27,-16,38,54
2009,32,Burnley,18,24,-33,31,64
2009,32,Hull City,19,24,-37,29,66
2009,32,Portsmouth,20,13,-30,28,58
2009,33,Man Utd,1,72,51,76,25
2009,33,Chelsea,2,71,53,82,29
2009,33,Arsenal,3,68,40,74,34
2009,33,Spurs,4,61,29,58,29
2009,33,Man City,5,56,18,58,40
2009,33,Liverpool,6,54,21,53,32
2009,33,Aston Villa,7,54,13,45,32
2009,33,Everton,8,49,8,50,42
2009,33,Birmingham,9,45,-4,33,37
2009,33,Stoke City,10,42,-4,31,35
2009,33,Blackburn,11,41,-15,35,50
2009,33,Fulham,12,38,-4,33,37
2009,33,Sunderland,13,35,-9,41,50
2009,33,Wolves,14,32,-22,28,50
2009,33,Bolton,15,32,-24,36,60
2009,33,Wigan,16,31,-33,29,62
2009,33,West Ham,17,27,-17,38,55
2009,33,Hull City,18,27,-35,31,66
2009,33,Burnley,19,24,-34,31,65
2009,33,Portsmouth,20,13,-32,28,60
2009,34,Chelsea,1,74,54,84,30
2009,34,Man Utd,2,72,50,77,27
2009,34,Arsenal,3,71,41,75,34
2009,34,Spurs,4,61,27,59,32
2009,34,Man City,5,59,23,64,41
2009,34,Aston Villa,6,57,14,46,32
2009,34,Liverpool,7,55,21,54,33
2009,34,Everton,8,50,8,52,44
2009,34,Birmingham,9,46,-4,34,38
2009,34,Stoke City,10,45,-2,33,35
2009,34,Blackburn,11,42,-15,35,50
2009,34,Fulham,12,41,-3,35,38
2009,34,Sunderland,13,38,-7,44,51
2009,34,Wolves,14,32,-23,28,51
2009,34,Bolton,15,32,-25,36,61
2009,34,Wigan,16,31,-34,30,64
2009,34,West Ham,17,28,-17,40,57
2009,34,Hull City,18,27,-37,31,68
2009,34,Burnley,19,24,-39,32,71
2009,34,Portsmouth,20,14,-32,28,60
2009,35,Chelsea,1,77,55,85,30
2009,35,Man Utd,2,73,50,77,27
2009,35,Arsenal,3,71,40,76,36
2009,35,Spurs,4,64,28,61,33
2009,35,Man City,5,62,27,69,42
2009,35,Aston Villa,6,58,14,48,34
2009,35,Liverpool,7,56,21,54,33
2009,35,Everton,8,51,8,54,46
2009,35,Stoke City,9,46,-2,33,35
2009,35,Birmingham,10,46,-8,35,43
2009,35,Blackburn,11,43,-15,35,50
2009,35,Fulham,12,42,-3,35,38
2009,35,Sunderland,13,38,-8,44,52
2009,35,Wolves,14,33,-23,28,51
2009,35,Bolton,15,32,-26,36,62
2009,35,Wigan,16,32,-34,30,64
2009,35,West Ham,17,31,-16,41,57
2009,35,Burnley,18,27,-36,36,72
2009,35,Hull City,19,27,-40,32,72
2009,35,Portsmouth,20,15,-32,28,60
2009,36,Chelsea,1,77,54,86,32
2009,36,Man Utd,2,76,51,78,27
2009,36,Arsenal,3,71,39,78,39
2009,36,Spurs,4,67,29,63,34
2009,36,Man City,5,62,26,69,43
2009,36,Aston Villa,6,61,15,50,35
2009,36,Liverpool,7,59,24,57,33
2009,36,Everton,8,54,9,57,48
2009,36,Birmingham,9,47,-8,35,43
2009,36,Stoke City,10,46,-3,34,37
2009,36,Fulham,11,43,-3,35,38
2009,36,Blackburn,12,43,-16,37,53
2009,36,Sunderland,13,41,-7,46,53
2009,36,Bolton,14,35,-25,38,63
2009,36,Wigan,15,35,-33,33,66
2009,36,Wolves,16,34,-23,28,51
2009,36,West Ham,17,31,-19,41,60
2009,36,Hull City,18,28,-40,32,72
2009,36,Burnley,19,27,-37,37,74
2009,36,Portsmouth,20,15,-33,29,62
2009,37,Chelsea,1,80,61,93,32
2009,37,Man Utd,2,79,53,81,28
2009,37,Arsenal,3,72,39,78,39
2009,37,Spurs,4,67,27,64,37
2009,37,Aston Villa,5,64,16,51,35
2009,37,Man City,6,63,26,69,43
2009,37,Liverpool,7,62,28,61,33
2009,37,Everton,8,57,10,59,49
2009,37,Birmingham,9,47,-9,35,44
2009,37,Stoke City,10,46,-10,34,44
2009,37,Sunderland,11,44,-6,47,53
2009,37,Blackburn,12,44,-16,38,54
2009,37,Fulham,13,43,-4,36,40
2009,37,Bolton,14,36,-25,40,65
2009,37,Wolves,15,35,-23,29,52
2009,37,Wigan,16,35,-34,35,69
2009,37,West Ham,17,34,-18,44,62
2009,37,Hull City,18,28,-41,32,73
2009,37,Burnley,19,27,-41,37,78
2009,37,Portsmouth,20,16,-33,31,64
2009,38,Chelsea,1,83,63,95,32
2009,38,Man Utd,2,82,54,82,28
2009,38,Arsenal,3,72,38,79,41
2009,38,Spurs,4,70,28,65,37
2009,38,Man City,5,66,28,72,44
2009,38,Aston Villa,6,64,14,52,38
2009,38,Liverpool,7,62,26,61,35
2009,38,Everton,8,58,10,59,49
2009,38,Birmingham,9,50,-8,37,45
2009,38,Stoke City,10,47,-10,34,44
2009,38,Blackburn,11,47,-15,40,55
2009,38,Fulham,12,46,-3,39,42
2009,38,Sunderland,13,44,-7,47,54
2009,38,Bolton,14,36,-26,40,66
2009,38,Wigan,15,36,-34,37,71
2009,38,Wolves,16,35,-25,30,55
2009,38,West Ham,17,34,-19,46,65
2009,38,Hull City,18,29,-41,34,75
2009,38,Burnley,19,27,-42,38,80
2009,38,Portsmouth,20,19,-31,34,65
2009,39,Chelsea,1,86,71,103,32
2009,39,Man Utd,2,85,58,86,28
2009,39,Arsenal,3,75,42,83,41
2009,39,Spurs,4,70,26,67,41
2009,39,Man City,5,67,28,73,45
2009,39,Aston Villa,6,64,13,52,39
2009,39,Liverpool,7,63,26,61,35
2009,39,Everton,8,61,11,60,49
2009,39,Birmingham,9,50,-9,38,47
2009,39,Blackburn,10,50,-14,41,55
2009,39,Stoke City,11,47,-14,34,48
2009,39,Fulham,12,46,-7,39,46
2009,39,Sunderland,13,44,-8,48,56
2009,39,Bolton,14,39,-25,42,67
2009,39,Wolves,15,38,-24,32,56
2009,39,Wigan,16,36,-42,37,79
2009,39,West Ham,17,35,-19,47,66
2009,39,Burnley,18,30,-40,42,82
2009,39,Hull City,19,30,-41,34,75
2009,39,Portsmouth,20,19,-32,34,66
2010,2,Chelsea,1,3,6,6,0
2010,2,Blackpool,2,3,4,4,0
2010,2,Aston Villa,3,3,3,3,0
2010,2,Man Utd,4,3,3,3,0
2010,2,Wolves,5,3,1,2,1
2010,2,Blackburn,6,3,1,1,0
2010,2,Sunderland,7,1,0,2,2
2010,2,Birmingham,8,1,0,2,2
2010,2,Arsenal,9,1,0,1,1
2010,2,Liverpool,10,1,0,1,1
2010,2,Spurs,11,1,0,0,0
2010,2,Man City,12,1,0,0,0
2010,2,Bolton,13,1,0,0,0
2010,2,Fulham,14,1,0,0,0
2010,2,Stoke City,15,0,-1,1,2
2010,2,Everton,16,0,-1,0,1
2010,2,West Ham,17,0,-3,0,3
2010,2,Newcastle,18,0,-3,0,3
2010,2,Wigan,19,0,-4,0,4
2010,2,West Brom,20,0,-6,0,6
2010,3,Chelsea,1,6,12,12,0
2010,3,Arsenal,2,4,6,7,1
2010,3,Man Utd,3,4,3,5,2
2010,3,Man City,4,4,3,3,0
2010,3,Bolton,5,4,2,3,1
2010,3,Birmingham,6,4,1,4,3
2010,3,Wolves,7,4,1,3,2
2010,3,Spurs,8,4,1,2,1
2010,3,Newcastle,9,3,3,6,3
2010,3,Blackburn,10,3,0,2,2
2010,3,Blackpool,11,3,-2,4,6
2010,3,Aston Villa,12,3,-3,3,6
2010,3,West Brom,13,3,-5,1,6
2010,3,Fulham,14,2,0,2,2
2010,3,Sunderland,15,1,-1,2,3
2010,3,Everton,16,1,-1,1,2
2010,3,Liverpool,17,1,-3,1,4
2010,3,Stoke City,18,0,-2,2,4
2010,3,West Ham,19,0,-5,1,6
2010,3,Wigan,20,0,-10,0,10
2010,4,Chelsea,1,9,14,14,0
2010,4,Arsenal,2,7,7,9,2
2010,4,Man Utd,3,7,6,8,2
2010,4,Aston Villa,4,6,-2,4,6
2010,4,Bolton,5,5,2,5,3
2010,4,Birmingham,6,5,1,6,5
2010,4,Wolves,7,5,1,4,3
2010,4,Newcastle,8,4,3,7,4
2010,4,Man City,9,4,2,3,1
2010,4,Sunderland,10,4,0,3,3
2010,4,Spurs,11,4,0,2,2
2010,4,Blackpool,12,4,-2,6,8
2010,4,Liverpool,13,4,-2,2,4
2010,4,Fulham,14,3,0,4,4
2010,4,Blackburn,15,3,-1,3,4
2010,4,West Brom,16,3,-6,1,7
2010,4,Wigan,17,3,-9,1,10
2010,4,Everton,18,1,-2,1,3
2010,4,Stoke City,19,0,-4,2,6
2010,4,West Ham,20,0,-8,1,9
2010,5,Chelsea,1,12,16,17,1
2010,5,Arsenal,2,10,10,13,3
2010,5,Man Utd,3,8,6,11,5
2010,5,Blackpool,4,7,0,8,8
2010,5,Birmingham,5,6,1,6,5
2010,5,Fulham,6,6,1,6,5
2010,5,Aston Villa,7,6,-3,5,8
2010,5,Man City,8,5,2,4,2
2010,5,Wolves,9,5,0,5,5
2010,5,Sunderland,10,5,0,4,4
2010,5,Spurs,11,5,0,3,3
2010,5,Bolton,12,5,-1,6,7
2010,5,Liverpool,13,5,-2,2,4
2010,5,Newcastle,14,4,1,7,6
2010,5,Blackburn,15,4,-1,4,5
2010,5,West Brom,16,4,-6,2,8
2010,5,Wigan,17,4,-9,2,11
2010,5,Stoke City,18,3,-3,4,7
2010,5,Everton,19,2,-2,4,6
2010,5,West Ham,20,0,-10,2,12
2010,6,Chelsea,1,15,20,21,1
2010,6,Arsenal,2,11,10,14,4
2010,6,Man Utd,3,11,7,14,7
2010,6,Man City,4,8,4,6,2
2010,6,Spurs,5,8,2,6,4
2010,6,Newcastle,6,7,2,8,6
2010,6,Fulham,7,7,1,7,6
2010,6,Aston Villa,8,7,-3,6,9
2010,6,Blackpool,9,7,-4,8,12
2010,6,West Brom,10,7,-4,5,9
2010,6,Sunderland,11,6,0,5,5
2010,6,Birmingham,12,6,-1,7,8
2010,6,Bolton,13,6,-1,7,8
2010,6,Blackburn,14,5,-1,5,6
2010,6,Wolves,15,5,-2,6,8
2010,6,Liverpool,16,5,-3,4,7
2010,6,Stoke City,17,4,-3,5,8
2010,6,Wigan,18,4,-11,2,13
2010,6,Everton,19,2,-3,4,7
2010,6,West Ham,20,1,-10,3,13
2010,7,Chelsea,1,15,19,21,2
2010,7,Man Utd,2,12,7,16,9
2010,7,Arsenal,3,11,9,16,7
2010,7,Man City,4,11,5,7,2
2010,7,Aston Villa,5,10,-2,8,10
2010,7,West Brom,6,10,-3,8,11
2010,7,Fulham,7,8,1,7,6
2010,7,Spurs,8,8,1,6,5
2010,7,Blackburn,9,8,0,7,7
2010,7,Newcastle,10,7,1,9,8
2010,7,Sunderland,11,7,0,7,7
2010,7,Bolton,12,7,-1,9,10
2010,7,Birmingham,13,7,-1,7,8
2010,7,Stoke City,14,7,-2,7,9
2010,7,Blackpool,15,7,-5,9,14
2010,7,Liverpool,16,6,-3,6,9
2010,7,Wolves,17,5,-3,7,10
2010,7,Wigan,18,5,-11,2,13
2010,7,West Ham,19,4,-9,4,13
2010,7,Everton,20,3,-3,4,7
2010,8,Chelsea,1,18,21,23,2
2010,8,Man City,2,14,6,9,3
2010,8,Man Utd,3,13,7,16,9
2010,8,Arsenal,4,11,7,16,9
2010,8,Spurs,5,11,2,8,6
2010,8,West Brom,6,11,-3,9,12
2010,8,Stoke City,7,10,-1,8,9
2010,8,Aston Villa,8,10,-3,9,12
2010,8,Blackpool,9,10,-4,11,15
2010,8,Fulham,10,9,1,8,7
2010,8,Sunderland,11,8,0,7,7
2010,8,Bolton,12,8,-1,10,11
2010,8,Blackburn,13,8,-1,7,8
2010,8,Wigan,14,8,-9,4,13
2010,8,Newcastle,15,7,0,10,10
2010,8,Birmingham,16,7,-3,7,10
2010,8,Everton,17,6,-1,6,7
2010,8,Liverpool,18,6,-4,7,11
2010,8,Wolves,19,5,-5,7,12
2010,8,West Ham,20,5,-9,5,14
2010,9,Chelsea,1,19,21,23,2
2010,9,Man City,2,17,7,12,5
2010,9,Arsenal,3,14,8,18,10
2010,9,Man Utd,4,14,7,18,11
2010,9,Spurs,5,14,3,10,7
2010,9,West Brom,6,12,-3,11,14
2010,9,Bolton,7,11,0,12,12
2010,9,Aston Villa,8,11,-3,9,12
2010,9,Stoke City,9,10,-2,9,11
2010,9,Blackpool,10,10,-5,13,18
2010,9,Everton,11,9,1,8,7
2010,9,Fulham,12,9,0,9,9
2010,9,Sunderland,13,9,0,7,7
2010,9,Blackburn,14,9,-1,7,8
2010,9,Wigan,15,9,-9,6,15
2010,9,Newcastle,16,8,0,12,12
2010,9,Birmingham,17,7,-4,8,12
2010,9,Wolves,18,6,-5,8,13
2010,9,Liverpool,19,6,-6,7,13
2010,9,West Ham,20,6,-9,6,15
2010,10,Chelsea,1,22,23,25,2
2010,10,Arsenal,2,17,11,21,10
2010,10,Man Utd,3,17,8,20,12
2010,10,Man City,4,17,4,12,8
2010,10,Spurs,5,15,3,11,8
2010,10,West Brom,6,15,-2,13,15
2010,10,Sunderland,7,12,1,8,7
2010,10,Bolton,8,12,0,13,13
2010,10,Newcastle,9,11,1,14,13
2010,10,Aston Villa,10,11,-4,9,13
2010,10,Everton,11,10,1,9,8
2010,10,Birmingham,12,10,-2,10,12
2010,10,Stoke City,13,10,-3,10,13
2010,10,Blackpool,14,10,-7,13,20
2010,10,Wigan,15,10,-9,7,16
2010,10,Fulham,16,9,-1,10,11
2010,10,Blackburn,17,9,-2,8,10
2010,10,Liverpool,18,9,-5,9,14
2010,10,Wolves,19,6,-7,8,15
2010,10,West Ham,20,6,-10,7,17
2010,11,Chelsea,1,25,24,27,3
2010,11,Arsenal,2,20,12,22,10
2010,11,Man Utd,3,20,10,22,12
2010,11,Man City,4,17,3,13,10
2010,11,Spurs,5,15,1,11,10
2010,11,West Brom,6,15,-3,14,17
2010,11,Newcastle,7,14,5,19,14
2010,11,Everton,8,13,2,10,8
2010,11,Blackpool,9,13,-6,15,21
2010,11,Fulham,10,12,1,12,11
2010,11,Bolton,11,12,-1,13,14
2010,11,Sunderland,12,12,-3,9,12
2010,11,Liverpool,13,12,-4,10,14
2010,11,Aston Villa,14,12,-4,9,13
2010,11,Birmingham,15,11,-2,10,12
2010,11,Stoke City,16,10,-4,10,14
2010,11,Wigan,17,10,-11,7,18
2010,11,Blackburn,18,9,-3,9,12
2010,11,Wolves,19,9,-6,10,16
2010,11,West Ham,20,6,-11,7,18
2010,12,Chelsea,1,25,22,27,5
2010,12,Man Utd,2,23,11,24,13
2010,12,Arsenal,3,20,11,22,11
2010,12,Man City,4,20,5,15,10
2010,12,Newcastle,5,17,6,20,14
2010,12,Bolton,6,15,1,17,16
2010,12,Spurs,7,15,-1,13,14
2010,12,Sunderland,8,15,-1,11,12
2010,12,Liverpool,9,15,-2,12,14
2010,12,West Brom,10,15,-5,14,19
2010,12,Everton,11,14,2,12,10
2010,12,Blackpool,12,14,-6,17,23
2010,12,Fulham,13,13,1,13,12
2010,12,Aston Villa,14,13,-4,10,14
2010,12,Birmingham,15,12,-2,12,14
2010,12,Blackburn,16,12,-2,11,13
2010,12,Stoke City,17,10,-6,10,16
2010,12,Wigan,18,10,-12,8,20
2010,12,Wolves,19,9,-7,11,18
2010,12,West Ham,20,7,-11,9,20
2010,13,Chelsea,1,28,23,28,5
2010,13,Man Utd,2,24,11,24,13
2010,13,Arsenal,3,23,13,24,11
2010,13,Man City,4,21,5,15,10
2010,13,Newcastle,5,17,5,21,16
2010,13,Bolton,6,16,1,18,17
2010,13,Spurs,7,16,-1,14,15
2010,13,Sunderland,8,16,-1,12,13
2010,13,Liverpool,9,16,-2,13,15
2010,13,Aston Villa,10,16,-3,13,16
2010,13,West Brom,11,16,-5,16,21
2010,13,Everton,12,15,2,13,11
2010,13,Blackburn,13,15,-1,13,14
2010,13,Blackpool,14,14,-7,19,26
2010,13,Fulham,15,13,0,13,13
2010,13,Stoke City,16,13,-5,13,18
2010,13,Birmingham,17,12,-3,14,17
2010,13,Wigan,18,11,-12,9,21
2010,13,Wolves,19,9,-9,11,20
2010,13,West Ham,20,8,-11,11,22
2010,14,Chelsea,1,28,20,28,8
2010,14,Arsenal,2,26,14,26,12
2010,14,Man Utd,3,25,11,26,15
2010,14,Man City,4,22,5,15,10
2010,14,Bolton,5,19,2,21,19
2010,14,Sunderland,6,19,2,15,13
2010,14,Spurs,7,19,1,18,17
2010,14,Newcastle,8,18,5,21,16
2010,14,Aston Villa,9,17,-3,15,18
2010,14,Stoke City,10,16,-3,15,18
2010,14,Liverpool,11,16,-4,13,17
2010,14,West Brom,12,16,-6,16,22
2010,14,Everton,13,15,1,14,13
2010,14,Blackburn,14,15,-3,15,18
2010,14,Blackpool,15,15,-7,19,26
2010,14,Fulham,16,14,0,13,13
2010,14,Wigan,17,14,-11,10,21
2010,14,Birmingham,18,13,-3,14,17
2010,14,Wolves,19,9,-10,13,23
2010,14,West Ham,20,9,-11,11,22
2010,15,Chelsea,1,28,19,28,9
2010,15,Man Utd,2,28,13,28,15
2010,15,Arsenal,3,26,13,28,15
2010,15,Man City,4,25,8,19,11
2010,15,Bolton,5,22,6,26,20
2010,15,Spurs,6,22,2,21,19
2010,15,Sunderland,7,20,2,17,15
2010,15,Stoke City,8,19,0,18,18
2010,15,Liverpool,9,19,-1,16,17
2010,15,Newcastle,10,18,1,22,21
2010,15,Blackburn,11,18,-1,17,18
2010,15,Blackpool,12,18,-6,21,27
2010,15,Aston Villa,13,17,-5,15,20
2010,15,Everton,14,16,1,16,15
2010,15,Birmingham,15,16,-2,15,17
2010,15,West Brom,16,16,-9,16,25
2010,15,Fulham,17,14,-3,14,17
2010,15,Wigan,18,14,-13,10,23
2010,15,Wolves,19,9,-11,14,25
2010,15,West Ham,20,9,-14,11,25
2010,16,Man Utd,1,31,19,35,16
2010,16,Chelsea,2,29,19,29,10
2010,16,Arsenal,3,29,15,32,17
2010,16,Man City,4,26,8,20,12
2010,16,Spurs,5,25,3,23,20
2010,16,Bolton,6,23,6,28,22
2010,16,Sunderland,7,20,1,19,18
2010,16,Stoke City,8,20,0,19,19
2010,16,Newcastle,9,19,1,23,22
2010,16,Liverpool,10,19,-2,17,19
2010,16,Blackpool,11,19,-6,23,29
2010,16,West Brom,12,19,-6,20,26
2010,16,Blackburn,13,18,-7,18,25
2010,16,Birmingham,14,17,-2,16,18
2010,16,Aston Villa,15,17,-7,17,24
2010,16,Everton,16,16,-2,17,19
2010,16,Fulham,17,15,-3,15,18
2010,16,Wigan,18,14,-15,11,26
2010,16,Wolves,19,12,-10,17,27
2010,16,West Ham,20,12,-12,14,26
2010,17,Man Utd,1,34,20,38,18
2010,17,Arsenal,2,32,16,34,18
2010,17,Chelsea,3,30,19,30,11
2010,17,Man City,4,29,9,21,12
2010,17,Spurs,5,26,3,24,21
2010,17,Bolton,6,23,5,28,23
2010,17,Sunderland,7,23,2,20,18
2010,17,Liverpool,8,22,1,20,19
2010,17,West Brom,9,22,-4,23,27
2010,17,Stoke City,10,21,0,21,21
2010,17,Blackburn,11,21,-4,21,25
2010,17,Newcastle,12,19,-1,24,25
2010,17,Blackpool,13,19,-7,25,32
2010,17,Birmingham,14,18,-2,17,19
2010,17,Everton,15,17,-2,18,20
2010,17,Aston Villa,16,17,-10,17,27
2010,17,Fulham,17,15,-4,16,20
2010,17,Wigan,18,15,-15,13,28
2010,17,Wolves,19,12,-13,17,30
2010,17,West Ham,20,12,-13,14,27
2010,18,Man Utd,1,37,21,39,18
2010,18,Arsenal,2,32,15,34,19
2010,18,Man City,3,32,11,24,13
2010,18,Chelsea,4,31,19,31,12
2010,18,Spurs,5,27,3,25,22
2010,18,Bolton,6,26,6,30,24
2010,18,Sunderland,7,24,2,20,18
2010,18,Newcastle,8,22,1,27,26
2010,18,Liverpool,9,22,-1,21,22
2010,18,West Brom,10,22,-5,24,29
2010,18,Blackpool,11,22,-6,26,32
2010,18,Stoke City,12,21,-1,21,22
2010,18,Blackburn,13,21,-5,22,27
2010,18,Aston Villa,14,20,-9,19,28
2010,18,Everton,15,18,-2,18,20
2010,18,Birmingham,16,18,-3,17,20
2010,18,Fulham,17,16,-4,16,20
2010,18,Wigan,18,16,-15,13,28
2010,18,Wolves,19,15,-12,18,30
2010,18,West Ham,20,12,-15,15,30
2010,19,Man Utd,1,37,20,40,20
2010,19,Arsenal,2,35,16,35,19
2010,19,Chelsea,3,34,20,33,13
2010,19,Man City,4,32,10,25,15
2010,19,Sunderland,5,27,3,21,18
2010,19,Spurs,6,27,1,26,25
2010,19,Bolton,7,26,5,30,25
2010,19,Newcastle,8,25,3,29,26
2010,19,Liverpool,9,25,0,22,22
2010,19,Blackpool,10,25,-4,29,33
2010,19,West Brom,11,23,-5,25,30
2010,19,Aston Villa,12,23,-8,21,29
2010,19,Blackburn,13,22,-5,23,28
2010,19,Everton,14,21,-1,20,21
2010,19,Stoke City,15,21,-2,21,23
2010,19,Birmingham,16,18,-5,17,22
2010,19,Fulham,17,16,-5,16,21
2010,19,Wolves,18,16,-12,19,31
2010,19,Wigan,19,16,-16,14,30
2010,19,West Ham,20,13,-15,16,31
2010,20,Man Utd,1,40,22,42,20
2010,20,Arsenal,2,38,18,38,20
2010,20,Man City,3,35,12,28,16
2010,20,Chelsea,4,34,18,34,16
2010,20,Spurs,5,30,2,28,26
2010,20,Bolton,6,29,7,32,25
2010,20,Blackpool,7,28,-3,31,34
2010,20,Sunderland,8,27,1,21,20
2010,20,Newcastle,9,25,1,30,29
2010,20,Liverpool,10,25,-1,23,24
2010,20,Stoke City,11,24,0,23,23
2010,20,West Brom,12,23,-7,25,32
2010,20,Aston Villa,13,23,-9,22,31
2010,20,Everton,14,22,-1,21,22
2010,20,Blackburn,15,22,-7,23,30
2010,20,Birmingham,16,19,-5,18,23
2010,20,Wigan,17,19,-15,16,31
2010,20,Fulham,18,16,-7,17,24
2010,20,Wolves,19,16,-13,20,33
2010,20,West Ham,20,16,-13,19,32
2010,21,Man Utd,1,41,22,43,21
2010,21,Arsenal,2,39,18,40,22
2010,21,Man City,3,38,16,32,16
2010,21,Chelsea,4,37,19,35,16
2010,21,Spurs,5,33,4,30,26
2010,21,Blackpool,6,31,-1,33,34
2010,21,Bolton,7,29,6,32,26
2010,21,Sunderland,8,27,-1,21,22
2010,21,Newcastle,9,25,-1,30,31
2010,21,Liverpool,10,25,-2,23,25
2010,21,Blackburn,11,25,-5,26,31
2010,21,Stoke City,12,24,-2,23,25
2010,21,Everton,13,23,-1,22,23
2010,21,West Brom,14,23,-9,26,35
2010,21,Aston Villa,15,23,-13,22,35
2010,21,Birmingham,16,20,-5,19,24
2010,21,Wigan,17,20,-15,18,33
2010,21,Fulham,18,19,-5,19,24
2010,21,Wolves,19,19,-12,21,33
2010,21,West Ham,20,17,-13,20,33
2010,22,Man Utd,1,44,23,45,22
2010,22,Arsenal,2,42,21,43,22
2010,22,Man City,3,41,17,33,16
2010,22,Chelsea,4,38,19,38,19
2010,22,Spurs,5,36,5,31,26
2010,22,Blackpool,6,31,-2,33,35
2010,22,Sunderland,7,30,2,24,22
2010,22,Bolton,8,29,5,33,28
2010,22,Newcastle,9,28,0,31,31
2010,22,Liverpool,10,28,-1,25,26
2010,22,Stoke City,11,27,0,25,25
2010,22,Blackburn,12,25,-8,26,34
2010,22,Aston Villa,13,24,-13,25,38
2010,22,Everton,14,23,-3,22,25
2010,22,West Brom,15,23,-10,27,37
2010,22,Birmingham,16,20,-8,19,27
2010,22,West Ham,17,20,-11,22,33
2010,22,Wigan,18,20,-16,18,34
2010,22,Fulham,19,19,-6,19,25
2010,22,Wolves,20,19,-14,21,35
2010,23,Man Utd,1,47,24,47,23
2010,23,Arsenal,2,43,21,43,22
2010,23,Man City,3,42,17,33,16
2010,23,Chelsea,4,38,18,38,20
2010,23,Spurs,5,36,4,32,28
2010,23,Sunderland,6,33,3,25,22
2010,23,Newcastle,7,31,5,36,31
2010,23,Blackpool,8,31,-3,34,37
2010,23,Bolton,9,30,5,34,29
2010,23,Liverpool,10,28,-3,26,29
2010,23,Blackburn,11,28,-6,29,35
2010,23,Stoke City,12,27,-1,26,27
2010,23,Everton,13,26,-2,24,26
2010,23,Aston Villa,14,24,-14,25,39
2010,23,Birmingham,15,23,-7,21,28
2010,23,West Brom,16,23,-13,27,40
2010,23,Fulham,17,22,-3,22,25
2010,23,Wolves,18,22,-13,22,35
2010,23,Wigan,19,21,-16,19,35
2010,23,West Ham,20,20,-16,22,38
2010,24,Man Utd,1,48,24,47,23
2010,24,Arsenal,2,46,24,46,22
2010,24,Man City,3,45,18,37,19
2010,24,Chelsea,4,41,20,40,20
2010,24,Spurs,5,37,4,32,28
2010,24,Sunderland,6,34,3,26,23
2010,24,Newcastle,7,32,5,37,32
2010,24,Blackpool,8,31,-4,36,40
2010,24,Bolton,9,30,3,34,31
2010,24,Stoke City,10,30,1,28,27
2010,24,Liverpool,11,29,-3,28,31
2010,24,Blackburn,12,28,-8,29,37
2010,24,Everton,13,27,-2,26,28
2010,24,West Brom,14,26,-12,30,42
2010,24,Aston Villa,15,25,-14,26,40
2010,24,Birmingham,16,24,-7,22,29
2010,24,Fulham,17,23,-3,23,26
2010,24,Wolves,18,22,-14,25,39
2010,24,Wigan,19,22,-16,20,36
2010,24,West Ham,20,20,-19,22,41
2010,25,Man Utd,1,51,29,52,23
2010,25,Arsenal,2,49,27,49,22
2010,25,Man City,3,45,17,37,20
2010,25,Chelsea,4,44,24,44,20
2010,25,Spurs,5,38,4,33,29
2010,25,Sunderland,6,37,4,28,24
2010,25,Newcastle,7,33,5,38,33
2010,25,Liverpool,8,32,0,31,31
2010,25,Blackpool,9,31,-5,37,42
2010,25,Blackburn,10,31,-6,31,37
2010,25,Bolton,11,30,-1,34,35
2010,25,Stoke City,12,30,-1,28,29
2010,25,Everton,13,28,-2,28,30
2010,25,Aston Villa,14,28,-13,27,40
2010,25,Fulham,15,26,-1,25,26
2010,25,West Brom,16,26,-14,30,44
2010,25,Birmingham,17,24,-12,22,34
2010,25,Wolves,18,22,-17,25,42
2010,25,Wigan,19,22,-19,20,39
2010,25,West Ham,20,21,-19,24,43
2010,26,Man Utd,1,54,31,55,24
2010,26,Arsenal,2,52,28,51,23
2010,26,Chelsea,3,47,26,48,22
2010,26,Man City,4,46,17,39,22
2010,26,Spurs,5,41,5,34,29
2010,26,Sunderland,6,37,2,30,28
2010,26,Liverpool,7,35,2,33,31
2010,26,Newcastle,8,33,4,38,34
2010,26,Bolton,9,33,0,35,35
2010,26,Blackpool,10,31,-7,38,45
2010,26,Blackburn,11,31,-7,31,38
2010,26,Stoke City,12,30,-3,28,31
2010,26,Fulham,13,29,0,26,26
2010,26,Everton,14,28,-3,29,32
2010,26,Aston Villa,15,28,-15,28,43
2010,26,West Brom,16,27,-14,32,46
2010,26,Birmingham,17,25,-12,24,36
2010,26,West Ham,18,24,-17,27,44
2010,26,Wigan,19,23,-19,22,41
2010,26,Wolves,20,22,-18,25,43
2010,27,Man Utd,1,54,30,56,26
2010,27,Arsenal,2,53,28,55,27
2010,27,Man City,3,49,20,42,22
2010,27,Chelsea,4,47,25,48,23
2010,27,Spurs,5,44,6,36,30
2010,27,Liverpool,6,38,3,34,31
2010,27,Sunderland,7,37,1,32,31
2010,27,Newcastle,8,34,4,42,38
2010,27,Bolton,9,33,-1,36,37
2010,27,Stoke City,10,33,-2,31,33
2010,27,Everton,11,31,-1,34,35
2010,27,Blackburn,12,31,-8,34,42
2010,27,Blackpool,13,31,-9,41,50
2010,27,Fulham,14,30,0,28,28
2010,27,Aston Villa,15,29,-15,30,45
2010,27,Birmingham,16,28,-11,25,36
2010,27,West Brom,17,27,-17,32,49
2010,27,Wigan,18,26,-18,26,44
2010,27,Wolves,19,25,-17,27,44
2010,27,West Ham,20,24,-18,27,45
2010,28,Man Utd,1,57,31,58,27
2010,28,Arsenal,2,56,30,57,27
2010,28,Man City,3,49,19,43,24
2010,28,Chelsea,4,48,25,48,23
2010,28,Spurs,5,47,7,38,31
2010,28,Liverpool,6,39,3,35,32
2010,28,Sunderland,7,37,0,33,33
2010,28,Bolton,8,36,1,38,37
2010,28,Newcastle,9,35,4,42,38
2010,28,Stoke City,10,33,-3,31,34
2010,28,Blackburn,11,32,-8,34,42
2010,28,Blackpool,12,32,-9,42,51
2010,28,Fulham,13,31,0,28,28
2010,28,Everton,14,31,-3,34,37
2010,28,Birmingham,15,31,-10,26,36
2010,28,Aston Villa,16,30,-15,31,46
2010,28,West Brom,17,28,-17,35,52
2010,28,Wigan,18,27,-18,27,45
2010,28,West Ham,19,25,-18,30,48
2010,28,Wolves,20,25,-19,27,46
2010,29,Man Utd,1,60,35,62,27
2010,29,Arsenal,2,57,30,60,30
2010,29,Chelsea,3,51,27,51,24
2010,29,Man City,4,50,19,44,25
2010,29,Spurs,5,48,7,41,34
2010,29,Liverpool,6,39,1,36,35
2010,29,Bolton,7,37,1,39,38
2010,29,Sunderland,8,37,-2,33,35
2010,29,Newcastle,9,36,4,43,39
2010,29,Everton,10,34,-1,36,37
2010,29,Stoke City,11,34,-3,32,35
2010,29,Aston Villa,12,33,-12,35,47
2010,29,Fulham,13,32,0,29,29
2010,29,Blackburn,14,32,-11,35,46
2010,29,Blackpool,15,32,-13,42,55
2010,29,Birmingham,16,31,-12,27,39
2010,29,West Brom,17,29,-17,36,53
2010,29,Wolves,18,28,-15,31,46
2010,29,West Ham,19,28,-16,33,49
2010,29,Wigan,20,27,-22,27,49
2010,30,Man Utd,1,60,33,63,30
2010,30,Arsenal,2,58,30,60,30
2010,30,Chelsea,3,54,29,54,25
2010,30,Man City,4,53,20,45,25
2010,30,Spurs,5,49,7,44,37
2010,30,Liverpool,6,42,3,39,36
2010,30,Bolton,7,40,2,42,40
2010,30,Sunderland,8,38,-2,33,35
2010,30,Everton,9,37,0,38,38
2010,30,Newcastle,10,36,3,44,41
2010,30,Fulham,11,35,1,32,31
2010,30,Stoke City,12,34,-6,32,38
2010,30,Aston Villa,13,33,-13,37,50
2010,30,Blackburn,14,32,-12,37,49
2010,30,Blackpool,15,32,-15,43,58
2010,30,West Brom,16,32,-15,39,54
2010,30,West Ham,17,31,-13,36,49
2010,30,Birmingham,18,31,-14,28,42
2010,30,Wolves,19,29,-15,34,49
2010,30,Wigan,20,27,-23,27,50
2010,31,Man Utd,1,63,34,64,30
2010,31,Arsenal,2,59,30,62,32
2010,31,Chelsea,3,57,31,56,25
2010,31,Man City,4,53,18,45,27
2010,31,Spurs,5,50,7,44,37
2010,31,Liverpool,6,45,5,41,36
2010,31,Bolton,7,40,1,42,41
2010,31,Everton,8,40,1,40,39
2010,31,Sunderland,9,38,-4,33,37
2010,31,Stoke City,10,37,-2,36,38
2010,31,Newcastle,11,36,-1,44,45
2010,31,Fulham,12,35,0,33,33
2010,31,Blackburn,13,33,-12,39,51
2010,31,Aston Villa,14,33,-14,37,51
2010,31,Blackpool,15,33,-15,45,60
2010,31,West Brom,16,33,-15,41,56
2010,31,West Ham,17,32,-13,36,49
2010,31,Wolves,18,32,-14,35,49
2010,31,Birmingham,19,31,-15,29,44
2010,31,Wigan,20,30,-22,29,51
2010,32,Man Utd,1,66,36,68,32
2010,32,Arsenal,2,60,30,62,32
2010,32,Chelsea,3,58,31,57,26
2010,32,Man City,4,56,23,50,27
2010,32,Spurs,5,51,7,44,37
2010,32,Liverpool,6,45,4,42,38
2010,32,Everton,7,41,1,42,41
2010,32,Bolton,8,40,0,43,43
2010,32,Newcastle,9,39,2,48,46
2010,32,Fulham,10,38,3,36,33
2010,32,Stoke City,11,38,-2,37,39
2010,32,Sunderland,12,38,-9,33,42
2010,32,West Brom,13,36,-14,43,57
2010,32,Blackburn,14,34,-12,39,51
2010,32,Aston Villa,15,34,-14,39,53
2010,32,Birmingham,16,34,-14,31,45
2010,32,Blackpool,17,33,-18,45,63
2010,32,West Ham,18,32,-15,38,53
2010,32,Wolves,19,32,-17,36,53
2010,32,Wigan,20,31,-22,29,51
2010,33,Man Utd,1,69,38,70,32
2010,33,Arsenal,2,63,32,65,33
2010,33,Chelsea,3,61,32,58,26
2010,33,Man City,4,56,20,50,30
2010,33,Spurs,5,54,8,47,39
2010,33,Liverpool,6,48,7,45,38
2010,33,Everton,7,44,4,45,41
2010,33,Bolton,8,43,3,46,43
2010,33,Newcastle,9,39,1,48,47
2010,33,West Brom,10,39,-13,46,59
2010,33,Fulham,11,38,1,36,35
2010,33,Stoke City,12,38,-3,39,42
2010,33,Sunderland,13,38,-10,35,45
2010,33,Aston Villa,14,37,-13,40,53
2010,33,Blackburn,15,35,-12,40,52
2010,33,Birmingham,16,35,-14,32,46
2010,33,Blackpool,17,33,-20,46,66
2010,33,West Ham,18,32,-18,38,56
2010,33,Wolves,19,32,-20,36,56
2010,33,Wigan,20,31,-23,29,52
2010,34,Man Utd,1,70,38,70,32
2010,34,Chelsea,2,64,34,61,27
2010,34,Arsenal,3,64,32,66,34
2010,34,Man City,4,59,21,51,30
2010,34,Spurs,5,54,7,47,40
2010,34,Liverpool,6,49,7,46,39
2010,34,Everton,7,47,6,47,41
2010,34,Bolton,8,43,0,46,46
2010,34,Fulham,9,41,4,39,35
2010,34,Stoke City,10,41,0,42,42
2010,34,Newcastle,11,40,1,48,47
2010,34,Aston Villa,12,40,-12,42,54
2010,34,West Brom,13,39,-15,47,62
2010,34,Sunderland,14,38,-12,35,47
2010,34,Birmingham,15,38,-12,34,46
2010,34,Blackburn,16,35,-14,40,54
2010,34,Wigan,17,34,-21,32,53
2010,34,Blackpool,18,33,-22,47,69
2010,34,West Ham,19,32,-19,39,58
2010,34,Wolves,20,32,-23,36,59
2010,35,Man Utd,1,73,39,71,32
2010,35,Chelsea,2,67,37,64,27
2010,35,Arsenal,3,64,31,67,36
2010,35,Man City,4,62,22,52,30
2010,35,Spurs,5,55,7,49,42
2010,35,Liverpool,6,52,12,51,39
2010,35,Everton,7,47,5,47,42
2010,35,Bolton,8,46,1,48,47
2010,35,Fulham,9,42,4,40,36
2010,35,Stoke City,10,42,0,43,43
2010,35,Newcastle,11,41,1,49,48
2010,35,Sunderland,12,41,-10,39,49
2010,35,Aston Villa,13,41,-12,43,55
2010,35,West Brom,14,40,-15,49,64
2010,35,Birmingham,15,38,-17,34,51
2010,35,Blackburn,16,35,-15,40,55
2010,35,Blackpool,17,34,-22,48,70
2010,35,Wigan,18,34,-23,34,57
2010,35,Wolves,19,33,-23,37,60
2010,35,West Ham,20,32,-22,39,61
2010,36,Man Utd,1,73,38,71,33
2010,36,Chelsea,2,70,38,66,28
2010,36,Arsenal,3,67,32,68,36
2010,36,Man City,4,65,23,54,31
2010,36,Liverpool,5,55,15,54,39
2010,36,Spurs,6,55,6,50,44
2010,36,Everton,7,48,5,48,43
2010,36,Bolton,8,46,0,48,48
2010,36,Fulham,9,45,7,43,36
2010,36,Stoke City,10,43,0,43,43
2010,36,West Brom,11,43,-14,51,65
2010,36,Newcastle,12,41,-2,49,51
2010,36,Aston Villa,13,41,-13,44,57
2010,36,Sunderland,14,41,-13,39,52
2010,36,Birmingham,15,39,-17,35,52
2010,36,Blackburn,16,38,-14,41,55
2010,36,Blackpool,17,35,-22,48,70
2010,36,Wigan,18,35,-23,35,58
2010,36,Wolves,19,34,-23,38,61
2010,36,West Ham,20,32,-23,40,63
2010,37,Man Utd,1,76,39,73,34
2010,37,Chelsea,2,70,37,67,30
2010,37,Arsenal,3,67,30,69,39
2010,37,Man City,4,65,22,55,33
2010,37,Liverpool,5,58,18,59,41
2010,37,Spurs,6,56,6,51,45
2010,37,Everton,7,51,6,50,44
2010,37,Stoke City,8,46,2,46,44
2010,37,Bolton,9,46,-1,49,50
2010,37,Fulham,10,45,4,45,41
2010,37,Newcastle,11,44,-1,51,52
2010,37,Sunderland,12,44,-12,41,53
2010,37,West Brom,13,43,-16,52,68
2010,37,Aston Villa,14,42,-13,45,58
2010,37,Blackburn,15,39,-14,42,56
2010,37,Birmingham,16,39,-18,36,54
2010,37,Wolves,17,37,-21,41,62
2010,37,Blackpool,18,36,-22,49,71
2010,37,Wigan,19,36,-23,36,59
2010,37,West Ham,20,33,-23,41,64
2010,38,Man Utd,1,77,39,74,35
2010,38,Chelsea,2,71,37,69,32
2010,38,Man City,3,68,25,58,33
2010,38,Arsenal,4,67,29,70,41
2010,38,Spurs,5,59,8,53,45
2010,38,Liverpool,6,58,16,59,43
2010,38,Everton,7,51,5,50,45
2010,38,Fulham,8,48,6,47,41
2010,38,Stoke City,9,46,-1,46,47
2010,38,Bolton,10,46,-2,52,54
2010,38,West Brom,11,46,-15,53,68
2010,38,Newcastle,12,45,-1,53,54
2010,38,Aston Villa,13,45,-12,47,59
2010,38,Sunderland,14,44,-14,42,56
2010,38,Blackburn,15,40,-14,43,57
2010,38,Wolves,16,40,-19,44,63
2010,38,Birmingham,17,39,-20,36,56
2010,38,Blackpool,18,39,-21,53,74
2010,38,Wigan,19,39,-22,39,61
2010,38,West Ham,20,33,-24,43,67
2010,39,Man Utd,1,80,41,78,37
2010,39,Chelsea,2,71,36,69,33
2010,39,Man City,3,71,27,60,33
2010,39,Arsenal,4,68,29,72,43
2010,39,Spurs,5,62,9,55,46
2010,39,Liverpool,6,58,15,59,44
2010,39,Everton,7,54,6,51,45
2010,39,Fulham,8,49,6,49,43
2010,39,Aston Villa,9,48,-11,48,59
2010,39,Sunderland,10,47,-11,45,56
2010,39,West Brom,11,47,-15,56,71
2010,39,Newcastle,12,46,-1,56,57
2010,39,Stoke City,13,46,-2,46,48
2010,39,Bolton,14,46,-4,52,56
2010,39,Blackburn,15,43,-13,46,59
2010,39,Wigan,16,42,-21,40,61
2010,39,Wolves,17,40,-20,46,66
2010,39,Birmingham,18,39,-21,37,58
2010,39,Blackpool,19,39,-23,55,78
2010,39,West Ham,20,33,-27,43,70
2011,2,Bolton,1,3,4,4,0
2011,2,Man City,2,3,4,4,0
2011,2,Spurs,3,3,2,2,0
2011,2,Wolves,4,3,1,2,1
2011,2,Man Utd,5,3,1,2,1
2011,2,Liverpool,6,1,0,1,1
2011,2,Sunderland,7,1,0,1,1
2011,2,Wigan,8,1,0,1,1
2011,2,Norwich,9,1,0,1,1
2011,2,Arsenal,10,1,0,0,0
2011,2,Aston Villa,11,1,0,0,0
2011,2,Stoke City,12,1,0,0,0
2011,2,Chelsea,13,1,0,0,0
2011,2,Newcastle,14,1,0,0,0
2011,2,Fulham,15,1,0,0,0
2011,2,Blackburn,16,0,-1,1,2
2011,2,West Brom,17,0,-1,1,2
2011,2,Everton,18,0,-2,0,2
2011,2,QPR,19,0,-4,0,4
2011,2,Swansea,20,0,-4,0,4
2011,3,Man City,1,6,5,7,2
2011,3,Man Utd,2,6,4,5,1
2011,3,Wolves,3,6,3,4,1
2011,3,Liverpool,4,4,2,3,1
2011,3,Aston Villa,5,4,2,3,1
2011,3,Chelsea,6,4,1,2,1
2011,3,Newcastle,7,4,1,1,0
2011,3,Bolton,8,3,3,6,3
2011,3,Spurs,9,3,-1,2,3
2011,3,QPR,10,3,-3,1,4
2011,3,Norwich,11,2,0,2,2
2011,3,Stoke City,12,2,0,1,1
2011,3,Wigan,13,2,0,1,1
2011,3,Sunderland,14,1,-1,1,2
2011,3,Arsenal,15,1,-2,0,2
2011,3,Fulham,16,1,-2,0,2
2011,3,Swansea,17,1,-4,0,4
2011,3,West Brom,18,0,-2,2,4
2011,3,Blackburn,19,0,-3,2,5
2011,3,Everton,20,0,-3,0,3
2011,4,Man Utd,1,9,10,13,3
2011,4,Man City,2,9,9,12,3
2011,4,Liverpool,3,7,4,6,2
2011,4,Chelsea,4,7,3,5,2
2011,4,Wolves,5,7,3,4,1
2011,4,Newcastle,6,7,2,3,1
2011,4,Aston Villa,7,5,2,3,1
2011,4,Wigan,8,5,2,3,1
2011,4,Stoke City,9,5,1,2,1
2011,4,Bolton,10,3,1,7,6
2011,4,Everton,11,3,-2,1,3
2011,4,Spurs,12,3,-5,3,8
2011,4,QPR,13,3,-5,1,6
2011,4,Sunderland,14,2,-1,1,2
2011,4,Norwich,15,2,-2,3,5
2011,4,Swansea,16,2,-4,0,4
2011,4,Fulham,17,1,-3,1,4
2011,4,Arsenal,18,1,-8,2,10
2011,4,West Brom,19,0,-3,2,5
2011,4,Blackburn,20,0,-4,2,6
2011,5,Man Utd,1,12,15,18,3
2011,5,Man City,2,12,12,15,3
2011,5,Chelsea,3,10,4,7,3
2011,5,Stoke City,4,8,2,3,1
2011,5,Newcastle,5,8,2,3,1
2011,5,Liverpool,6,7,3,6,3
2011,5,Wolves,7,7,1,4,3
2011,5,Aston Villa,8,6,2,5,3
2011,5,Spurs,9,6,-3,5,8
2011,5,Wigan,10,5,-1,3,4
2011,5,Everton,11,4,-2,3,5
2011,5,QPR,12,4,-5,1,6
2011,5,Arsenal,13,4,-7,3,10
2011,5,West Brom,14,3,-2,3,5
2011,5,Bolton,15,3,-4,7,11
2011,5,Sunderland,16,2,-2,2,4
2011,5,Norwich,17,2,-3,3,6
2011,5,Fulham,18,2,-3,2,5
2011,5,Swansea,19,2,-5,0,5
2011,5,Blackburn,20,1,-4,3,7
2011,6,Man Utd,1,15,17,21,4
2011,6,Man City,2,13,12,17,5
2011,6,Chelsea,3,10,2,8,6
2011,6,Newcastle,4,9,2,4,2
2011,6,Spurs,5,9,1,9,8
2011,6,Stoke City,6,8,-2,3,5
2011,6,Aston Villa,7,7,2,6,4
2011,6,Everton,8,7,0,6,6
2011,6,Liverpool,9,7,-1,6,7
2011,6,Wolves,10,7,-2,4,6
2011,6,QPR,11,7,-2,4,6
2011,6,Sunderland,12,5,2,6,4
2011,6,Norwich,13,5,-2,5,7
2011,6,Swansea,14,5,-2,3,5
2011,6,Wigan,15,5,-3,4,7
2011,6,Blackburn,16,4,-3,7,10
2011,6,Arsenal,17,4,-8,6,14
2011,6,Fulham,18,3,-3,4,7
2011,6,Bolton,19,3,-5,8,13
2011,6,West Brom,20,3,-5,3,8
2011,7,Man Utd,1,16,17,22,5
2011,7,Man City,2,16,14,19,5
2011,7,Chelsea,3,13,5,12,7
2011,7,Newcastle,4,12,4,7,3
2011,7,Spurs,5,12,2,11,9
2011,7,Liverpool,6,10,0,8,8
2011,7,Stoke City,7,9,-2,4,6
2011,7,Aston Villa,8,8,2,7,5
2011,7,Norwich,9,8,-1,7,8
2011,7,QPR,10,8,-2,5,7
2011,7,Everton,11,7,-2,6,8
2011,7,Wolves,12,7,-3,5,8
2011,7,Arsenal,13,7,-5,9,14
2011,7,Sunderland,14,5,1,7,6
2011,7,Wigan,15,5,-4,5,9
2011,7,Swansea,16,5,-5,4,9
2011,7,Fulham,17,4,-3,4,7
2011,7,Blackburn,18,4,-5,8,13
2011,7,West Brom,19,4,-5,3,8
2011,7,Bolton,20,3,-8,8,16
2011,8,Man Utd,1,19,19,24,5
2011,8,Man City,2,19,18,23,5
2011,8,Chelsea,3,16,9,17,8
2011,8,Newcastle,4,15,5,9,4
2011,8,Spurs,5,15,3,13,10
2011,8,Liverpool,6,13,2,10,8
2011,8,Aston Villa,7,11,4,9,5
2011,8,Stoke City,8,9,-4,4,8
2011,8,Norwich,9,8,-3,7,10
2011,8,Swansea,10,8,-3,6,9
2011,8,QPR,11,8,-8,5,13
2011,8,Fulham,12,7,3,10,7
2011,8,Everton,13,7,-4,6,10
2011,8,Wolves,14,7,-4,6,10
2011,8,Arsenal,15,7,-6,10,16
2011,8,Sunderland,16,6,1,9,8
2011,8,West Brom,17,5,-5,5,10
2011,8,Wigan,18,5,-6,5,11
2011,8,Blackburn,19,4,-9,8,17
2011,8,Bolton,20,3,-12,9,21
2011,9,Man City,1,22,21,27,6
2011,9,Man Utd,2,20,19,25,6
2011,9,Chelsea,3,19,11,20,9
2011,9,Newcastle,4,16,5,11,6
2011,9,Spurs,5,16,3,15,12
2011,9,Liverpool,6,14,2,11,9
2011,9,Stoke City,7,12,-2,6,8
2011,9,Aston Villa,8,11,1,10,9
2011,9,Norwich,9,11,-1,10,11
2011,9,Arsenal,10,10,-5,12,17
2011,9,QPR,11,9,-8,6,14
2011,9,West Brom,12,8,-3,7,10
2011,9,Swansea,13,8,-5,7,12
2011,9,Fulham,14,7,1,10,9
2011,9,Everton,15,7,-6,7,13
2011,9,Wolves,16,7,-6,6,12
2011,9,Sunderland,17,6,0,10,10
2011,9,Bolton,18,6,-10,12,22
2011,9,Wigan,19,5,-8,6,14
2011,9,Blackburn,20,5,-9,9,18
2011,10,Man City,1,25,26,33,7
2011,10,Man Utd,2,20,14,26,12
2011,10,Chelsea,3,19,10,20,10
2011,10,Newcastle,4,19,6,12,6
2011,10,Spurs,5,19,4,17,13
2011,10,Liverpool,6,15,2,12,10
2011,10,Arsenal,7,13,-3,15,18
2011,10,Norwich,8,12,-1,11,12
2011,10,Stoke City,9,12,-4,7,11
2011,10,QPR,10,12,-7,7,14
2011,10,Aston Villa,11,11,0,11,11
2011,10,West Brom,12,11,-2,9,11
2011,10,Everton,13,10,-4,10,14
2011,10,Sunderland,14,9,2,12,10
2011,10,Swansea,15,9,-5,9,14
2011,10,Wolves,16,8,-6,8,14
2011,10,Fulham,17,7,-1,11,12
2011,10,Bolton,18,6,-12,12,24
2011,10,Wigan,19,5,-9,6,15
2011,10,Blackburn,20,5,-10,10,20
2011,11,Man City,1,28,28,36,8
2011,11,Man Utd,2,23,15,27,12
2011,11,Newcastle,3,22,8,15,7
2011,11,Spurs,4,22,6,20,14
2011,11,Chelsea,5,19,8,23,15
2011,11,Liverpool,6,18,4,14,10
2011,11,Arsenal,7,16,-1,20,21
2011,11,Norwich,8,13,-1,14,15
2011,11,Aston Villa,9,12,0,13,13
2011,11,Swansea,10,12,-3,12,15
2011,11,Stoke City,11,12,-6,8,14
2011,11,QPR,12,12,-9,8,17
2011,11,West Brom,13,11,-4,9,13
2011,11,Sunderland,14,10,2,14,12
2011,11,Fulham,15,10,1,13,12
2011,11,Everton,16,10,-5,10,15
2011,11,Wolves,17,8,-8,9,17
2011,11,Blackburn,18,6,-10,13,23
2011,11,Bolton,19,6,-14,13,27
2011,11,Wigan,20,5,-11,6,17
2011,12,Man City,1,31,29,39,10
2011,12,Man Utd,2,26,16,28,12
2011,12,Newcastle,3,25,9,17,8
2011,12,Spurs,4,25,8,23,15
2011,12,Chelsea,5,22,9,24,15
2011,12,Liverpool,6,19,4,14,10
2011,12,Arsenal,7,19,2,23,21
2011,12,Aston Villa,8,15,1,16,15
2011,12,Norwich,9,13,-2,16,18
2011,12,Swansea,10,13,-3,12,15
2011,12,QPR,11,12,-10,10,20
2011,12,Stoke City,12,12,-11,8,19
2011,12,Wolves,13,11,-6,12,18
2011,12,West Brom,14,11,-7,9,16
2011,12,Sunderland,15,10,1,14,13
2011,12,Fulham,16,10,-1,14,15
2011,12,Everton,17,10,-6,11,17
2011,12,Bolton,18,9,-9,18,27
2011,12,Blackburn,19,6,-11,13,24
2011,12,Wigan,20,5,-13,7,20
2011,13,Man City,1,34,31,42,11
2011,13,Man Utd,2,29,17,29,12
2011,13,Spurs,3,28,10,25,15
2011,13,Newcastle,4,25,7,18,11
2011,13,Chelsea,5,22,8,25,17
2011,13,Liverpool,6,22,5,16,11
2011,13,Arsenal,7,22,3,25,22
2011,13,Aston Villa,8,15,-1,16,17
2011,13,QPR,9,15,-9,13,22
2011,13,West Brom,10,14,-6,11,17
2011,13,Norwich,11,13,-3,17,20
2011,13,Swansea,12,13,-4,12,16
2011,13,Everton,13,13,-5,13,18
2011,13,Stoke City,14,12,-12,10,22
2011,13,Sunderland,15,11,1,14,13
2011,13,Fulham,16,11,-1,14,15
2011,13,Wolves,17,11,-7,13,20
2011,13,Bolton,18,9,-10,19,29
2011,13,Blackburn,19,7,-11,16,27
2011,13,Wigan,20,6,-13,10,23
2011,14,Man City,1,35,31,43,12
2011,14,Spurs,2,31,12,28,16
2011,14,Man Utd,3,30,17,30,13
2011,14,Newcastle,4,26,7,19,12
2011,14,Chelsea,5,25,11,28,17
2011,14,Liverpool,6,23,5,17,12
2011,14,Arsenal,7,23,3,26,23
2011,14,Aston Villa,8,16,-1,16,17
2011,14,Norwich,9,16,-2,19,21
2011,14,Everton,10,16,-3,15,18
2011,14,QPR,11,15,-10,14,24
2011,14,Stoke City,12,15,-10,13,23
2011,14,Swansea,13,14,-4,12,16
2011,14,West Brom,14,14,-8,12,20
2011,14,Fulham,15,12,-1,15,16
2011,14,Sunderland,16,11,0,15,15
2011,14,Wolves,17,11,-10,13,23
2011,14,Bolton,18,9,-12,19,31
2011,14,Wigan,19,9,-12,12,24
2011,14,Blackburn,20,7,-13,17,30
2011,15,Man City,1,38,35,48,13
2011,15,Spurs,2,34,15,31,16
2011,15,Man Utd,3,33,18,31,13
2011,15,Chelsea,4,28,14,31,17
2011,15,Arsenal,5,26,7,30,23
2011,15,Newcastle,6,26,4,19,15
2011,15,Liverpool,7,23,4,17,13
2011,15,Stoke City,8,18,-9,14,23
2011,15,Aston Villa,9,16,-2,16,18
2011,15,Everton,10,16,-4,15,19
2011,15,Norwich,11,16,-6,20,26
2011,15,QPR,12,16,-10,15,25
2011,15,Fulham,13,15,0,16,16
2011,15,West Brom,14,15,-8,13,21
2011,15,Swansea,15,14,-6,14,20
2011,15,Wolves,16,14,-9,15,24
2011,15,Sunderland,17,11,-1,16,17
2011,15,Blackburn,18,10,-11,21,32
2011,15,Bolton,19,9,-15,19,34
2011,15,Wigan,20,9,-16,12,28
2011,16,Man City,1,38,34,49,15
2011,16,Man Utd,2,36,21,35,14
2011,16,Spurs,3,34,14,32,18
2011,16,Chelsea,4,31,15,33,18
2011,16,Arsenal,5,29,8,31,23
2011,16,Liverpool,6,26,5,18,13
2011,16,Newcastle,7,26,2,21,19
2011,16,Stoke City,8,21,-8,16,24
2011,16,Aston Villa,9,19,-1,18,19
2011,16,Norwich,10,19,-4,24,28
2011,16,Swansea,11,17,-4,16,20
2011,16,Everton,12,16,-5,15,20
2011,16,QPR,13,16,-11,15,26
2011,16,Fulham,14,15,-2,16,18
2011,16,West Brom,15,15,-9,14,23
2011,16,Sunderland,16,14,0,18,18
2011,16,Wolves,17,14,-12,16,28
2011,16,Wigan,18,12,-15,14,29
2011,16,Blackburn,19,10,-12,22,34
2011,16,Bolton,20,9,-16,20,36
2011,17,Man City,1,41,35,50,15
2011,17,Man Utd,2,39,23,37,14
2011,17,Spurs,3,37,15,33,18
2011,17,Chelsea,4,32,15,34,19
2011,17,Arsenal,5,29,7,31,24
2011,17,Liverpool,6,29,7,20,13
2011,17,Newcastle,7,27,2,21,19
2011,17,Stoke City,8,24,-7,18,25
2011,17,Norwich,9,20,-4,25,29
2011,17,Aston Villa,10,19,-3,18,21
2011,17,Fulham,11,18,0,18,18
2011,17,Swansea,12,18,-4,16,20
2011,17,West Brom,13,18,-8,16,24
2011,17,Everton,14,17,-5,16,21
2011,17,QPR,15,16,-13,15,28
2011,17,Sunderland,16,14,-1,18,19
2011,17,Wolves,17,14,-13,17,30
2011,17,Wigan,18,13,-15,15,30
2011,17,Blackburn,19,10,-13,23,36
2011,17,Bolton,20,9,-18,20,38
2011,18,Man City,1,44,38,53,15
2011,18,Man Utd,2,42,28,42,14
2011,18,Spurs,3,38,15,34,19
2011,18,Chelsea,4,33,15,35,20
2011,18,Arsenal,5,32,8,33,25
2011,18,Liverpool,6,30,7,20,13
2011,18,Newcastle,7,27,1,23,22
2011,18,Stoke City,8,24,-10,18,28
2011,18,Norwich,9,21,-4,27,31
2011,18,West Brom,10,21,-7,19,26
2011,18,Everton,11,20,-4,17,21
2011,18,Aston Villa,12,19,-4,19,23
2011,18,Fulham,13,18,-5,18,23
2011,18,Swansea,14,18,-5,16,21
2011,18,Sunderland,15,17,0,21,21
2011,18,QPR,16,16,-14,17,31
2011,18,Wolves,17,15,-13,19,32
2011,18,Wigan,18,14,-15,15,30
2011,18,Bolton,19,12,-17,22,39
2011,18,Blackburn,20,10,-14,24,38
2011,19,Man City,1,45,38,53,15
2011,19,Man Utd,2,45,33,47,14
2011,19,Spurs,3,41,17,36,19
2011,19,Chelsea,4,34,15,36,21
2011,19,Arsenal,5,33,8,34,26
2011,19,Liverpool,6,31,7,21,14
2011,19,Newcastle,7,30,3,25,22
2011,19,Stoke City,8,25,-10,18,28
2011,19,West Brom,9,22,-7,19,26
2011,19,Everton,10,21,-4,18,22
2011,19,Norwich,11,21,-6,27,33
2011,19,Aston Villa,12,20,-4,19,23
2011,19,Fulham,13,19,-5,19,24
2011,19,Swansea,14,19,-5,17,22
2011,19,Sunderland,15,18,0,22,22
2011,19,QPR,16,17,-14,18,32
2011,19,Wolves,17,16,-13,20,33
2011,19,Wigan,18,14,-20,15,35
2011,19,Bolton,19,12,-19,22,41
2011,19,Blackburn,20,11,-14,25,39
2011,20,Man City,1,45,37,53,16
2011,20,Man Utd,2,45,32,49,17
2011,20,Spurs,3,42,17,37,20
2011,20,Arsenal,4,36,9,35,26
2011,20,Chelsea,5,34,13,37,24
2011,20,Liverpool,6,34,9,24,15
2011,20,Newcastle,7,30,1,26,25
2011,20,Stoke City,8,26,-10,20,30
2011,20,Everton,9,24,-3,19,22
2011,20,Aston Villa,10,23,-2,22,24
2011,20,Norwich,11,22,-6,28,34
2011,20,West Brom,12,22,-8,19,27
2011,20,Sunderland,13,21,1,23,22
2011,20,Fulham,14,20,-5,20,25
2011,20,Swansea,15,20,-5,18,23
2011,20,Wolves,16,17,-13,21,34
2011,20,QPR,17,17,-15,18,33
2011,20,Wigan,18,15,-20,17,37
2011,20,Blackburn,19,14,-13,28,41
2011,20,Bolton,20,13,-19,23,42
2011,21,Man City,1,48,40,56,16
2011,21,Man Utd,2,45,29,49,20
2011,21,Spurs,3,45,18,38,20
2011,21,Chelsea,4,37,14,39,25
2011,21,Arsenal,5,36,8,36,28
2011,21,Liverpool,6,34,6,24,18
2011,21,Newcastle,7,33,4,29,25
2011,21,Stoke City,8,29,-9,22,31
2011,21,Norwich,9,25,-5,30,35
2011,21,Sunderland,10,24,4,27,23
2011,21,Everton,11,24,-4,20,24
2011,21,Swansea,12,23,-3,20,23
2011,21,Aston Villa,13,23,-4,22,26
2011,21,Fulham,14,23,-4,22,26
2011,21,West Brom,15,22,-9,19,28
2011,21,Wolves,16,17,-14,22,36
2011,21,QPR,17,17,-16,19,35
2011,21,Bolton,18,16,-18,25,43
2011,21,Wigan,19,15,-23,18,41
2011,21,Blackburn,20,14,-14,29,43
2011,22,Man City,1,51,41,57,16
2011,22,Man Utd,2,48,32,52,20
2011,22,Spurs,3,46,18,39,21
2011,22,Chelsea,4,40,15,40,25
2011,22,Arsenal,5,36,7,38,31
2011,22,Newcastle,6,36,5,30,25
2011,22,Liverpool,7,35,6,24,18
2011,22,Stoke City,8,30,-9,22,31
2011,22,Norwich,9,28,-4,32,36
2011,22,Swansea,10,26,-2,23,25
2011,22,Everton,11,25,-4,21,25
2011,22,Sunderland,12,24,3,27,24
2011,22,Aston Villa,13,24,-4,23,27
2011,22,Fulham,14,23,-6,23,29
2011,22,West Brom,15,22,-10,20,30
2011,22,Wolves,16,18,-14,23,37
2011,22,Blackburn,17,17,-12,32,44
2011,22,QPR,18,17,-17,19,36
2011,22,Bolton,19,16,-21,25,46
2011,22,Wigan,20,15,-24,18,42
2011,23,Man City,1,54,42,60,18
2011,23,Man Utd,2,51,33,54,21
2011,23,Spurs,3,46,17,41,24
2011,23,Chelsea,4,41,15,40,25
2011,23,Arsenal,5,36,6,39,33
2011,23,Newcastle,6,36,2,32,30
2011,23,Liverpool,7,35,4,25,21
2011,23,Stoke City,8,30,-10,23,33
2011,23,Norwich,9,29,-4,32,36
2011,23,Sunderland,10,27,5,29,24
2011,23,Aston Villa,11,27,-3,26,29
2011,23,Fulham,12,26,-3,28,31
2011,23,Swansea,13,26,-4,23,27
2011,23,Everton,14,26,-4,22,26
2011,23,West Brom,15,25,-9,22,31
2011,23,QPR,16,20,-15,22,37
2011,23,Bolton,17,19,-19,28,47
2011,23,Blackburn,18,18,-12,33,45
2011,23,Wolves,19,18,-15,25,40
2011,23,Wigan,20,15,-26,19,45
2011,24,Man City,1,54,41,60,19
2011,24,Man Utd,2,54,35,56,21
2011,24,Spurs,3,49,19,44,25
2011,24,Chelsea,4,42,15,41,26
2011,24,Newcastle,5,39,4,34,30
2011,24,Liverpool,6,38,7,28,21
2011,24,Arsenal,7,37,6,39,33
2011,24,Sunderland,8,30,8,32,24
2011,24,Stoke City,9,30,-12,23,35
2011,24,Everton,10,29,-3,23,26
2011,24,Norwich,11,29,-7,32,39
2011,24,Aston Villa,12,28,-3,28,31
2011,24,Fulham,13,27,-3,29,32
2011,24,Swansea,14,27,-4,24,28
2011,24,West Brom,15,26,-9,23,32
2011,24,QPR,16,21,-15,24,39
2011,24,Bolton,17,20,-19,28,47
2011,24,Blackburn,18,18,-14,33,47
2011,24,Wolves,19,18,-18,25,43
2011,24,Wigan,20,15,-28,20,48
2011,25,Man City,1,57,44,63,19
2011,25,Man Utd,2,55,35,59,24
2011,25,Spurs,3,50,19,44,25
2011,25,Chelsea,4,43,15,44,29
2011,25,Newcastle,5,42,5,36,31
2011,25,Arsenal,6,40,12,46,34
2011,25,Liverpool,7,39,7,28,21
2011,25,Sunderland,8,33,9,33,24
2011,25,Norwich,9,32,-5,34,39
2011,25,Swansea,10,30,-3,26,29
2011,25,Everton,11,30,-3,24,27
2011,25,Stoke City,12,30,-13,23,36
2011,25,Aston Villa,13,28,-4,29,33
2011,25,Fulham,14,27,-6,29,35
2011,25,West Brom,15,26,-10,24,34
2011,25,QPR,16,21,-16,25,41
2011,25,Wolves,17,21,-17,27,44
2011,25,Bolton,18,20,-21,28,49
2011,25,Blackburn,19,18,-20,34,54
2011,25,Wigan,20,16,-28,21,49
2011,26,Man City,1,60,45,64,19
2011,26,Man Utd,2,58,36,61,25
2011,26,Spurs,3,53,24,49,25
2011,26,Arsenal,4,43,13,48,35
2011,26,Chelsea,5,43,13,44,31
2011,26,Newcastle,6,42,0,36,36
2011,26,Liverpool,7,39,6,29,23
2011,26,Norwich,8,35,-4,37,41
2011,26,Sunderland,9,33,8,34,26
2011,26,Everton,10,33,-1,26,27
2011,26,Swansea,11,30,-4,28,32
2011,26,Fulham,12,30,-5,31,36
2011,26,Stoke City,13,30,-14,24,38
2011,26,West Brom,14,29,-6,29,35
2011,26,Aston Villa,15,28,-5,29,34
2011,26,QPR,16,21,-17,27,44
2011,26,Blackburn,17,21,-19,37,56
2011,26,Wolves,18,21,-21,28,49
2011,26,Bolton,19,20,-22,29,51
2011,26,Wigan,20,19,-27,23,50
2011,27,Man City,1,63,48,67,19
2011,27,Man Utd,2,61,37,63,26
2011,27,Spurs,3,53,21,51,30
2011,27,Arsenal,4,46,16,53,37
2011,27,Chelsea,5,46,16,47,31
2011,27,Newcastle,6,43,0,38,38
2011,27,Liverpool,7,42,9,32,23
2011,27,Norwich,8,35,-5,38,43
2011,27,Sunderland,9,33,4,34,30
2011,27,Fulham,10,33,-4,32,36
2011,27,Everton,11,33,-4,26,30
2011,27,Stoke City,12,33,-12,26,38
2011,27,West Brom,13,32,-2,33,35
2011,27,Swansea,14,30,-6,28,34
2011,27,Aston Villa,15,29,-5,29,34
2011,27,Wolves,16,22,-21,30,51
2011,27,QPR,17,21,-18,27,45
2011,27,Blackburn,18,21,-22,37,59
2011,27,Bolton,19,20,-25,29,54
2011,27,Wigan,20,20,-27,23,50
2011,28,Man City,1,66,50,69,19
2011,28,Man Utd,2,64,39,66,27
2011,28,Spurs,3,53,19,52,33
2011,28,Arsenal,4,49,17,55,38
2011,28,Chelsea,5,46,15,47,32
2011,28,Newcastle,6,44,0,39,39
2011,28,Liverpool,7,42,8,33,25
2011,28,Fulham,8,36,1,37,36
2011,28,Stoke City,9,36,-11,27,38
2011,28,West Brom,10,35,-1,34,35
2011,28,Norwich,11,35,-6,38,44
2011,28,Sunderland,12,34,4,35,31
2011,28,Everton,13,34,-4,27,31
2011,28,Swansea,14,33,-4,30,34
2011,28,Aston Villa,15,30,-5,30,35
2011,28,QPR,16,22,-18,28,46
2011,28,Blackburn,17,22,-22,38,60
2011,28,Wolves,18,22,-26,30,56
2011,28,Bolton,19,20,-27,29,56
2011,28,Wigan,20,20,-29,23,52
2011,29,Man Utd,1,67,41,68,27
2011,29,Man City,2,66,49,69,20
2011,29,Spurs,3,53,18,52,34
2011,29,Arsenal,4,52,18,57,39
2011,29,Chelsea,5,49,16,48,32
2011,29,Newcastle,6,44,-1,40,41
2011,29,Liverpool,7,42,7,33,26
2011,29,Sunderland,8,37,5,36,31
2011,29,Everton,9,37,-3,28,31
2011,29,Fulham,10,36,0,37,37
2011,29,Swansea,11,36,-3,31,34
2011,29,Norwich,12,36,-6,39,45
2011,29,Stoke City,13,36,-12,27,39
2011,29,West Brom,14,35,-3,34,37
2011,29,Aston Villa,15,33,-4,31,35
2011,29,Blackburn,16,25,-20,40,60
2011,29,Bolton,17,23,-26,31,57
2011,29,QPR,18,22,-19,29,48
2011,29,Wolves,19,22,-28,30,58
2011,29,Wigan,20,21,-29,24,53
2011,30,Man Utd,1,70,46,73,27
2011,30,Man City,2,69,50,71,21
2011,30,Arsenal,3,55,19,58,39
2011,30,Spurs,4,54,18,53,35
2011,30,Chelsea,5,49,15,49,34
2011,30,Newcastle,6,47,0,41,41
2011,30,Liverpool,7,42,6,35,29
2011,30,Swansea,8,39,0,34,34
2011,30,Sunderland,9,37,3,36,33
2011,30,Everton,10,37,-4,28,32
2011,30,Stoke City,11,37,-12,28,40
2011,30,Fulham,12,36,-3,37,40
2011,30,West Brom,13,36,-3,35,38
2011,30,Norwich,14,36,-7,39,46
2011,30,Aston Villa,15,33,-5,32,37
2011,30,Blackburn,16,28,-18,42,60
2011,30,Bolton,17,26,-25,33,58
2011,30,QPR,18,25,-18,32,50
2011,30,Wigan,19,22,-29,25,54
2011,30,Wolves,20,22,-33,30,63
2011,31,Man Utd,1,73,47,74,27
2011,31,Man City,2,70,50,72,22
2011,31,Arsenal,3,58,22,61,39
2011,31,Spurs,4,55,18,53,35
2011,31,Chelsea,5,50,15,49,34
2011,31,Newcastle,6,50,2,44,42
2011,31,Liverpool,7,42,5,36,31
2011,31,Sunderland,8,40,5,39,34
2011,31,Everton,9,40,-2,30,32
2011,31,Swansea,10,39,-2,34,36
2011,31,Norwich,11,39,-6,41,47
2011,31,Stoke City,12,38,-12,29,41
2011,31,Fulham,13,36,-4,37,41
2011,31,West Brom,14,36,-5,36,41
2011,31,Aston Villa,15,33,-8,32,40
2011,31,Bolton,16,29,-24,35,59
2011,31,Blackburn,17,28,-19,43,62
2011,31,QPR,18,25,-20,33,53
2011,31,Wigan,19,25,-28,27,55
2011,31,Wolves,20,22,-34,31,65
2011,32,Man Utd,1,76,49,76,27
2011,32,Man City,2,71,50,75,25
2011,32,Arsenal,3,58,21,62,41
2011,32,Spurs,4,58,20,56,36
2011,32,Chelsea,5,53,17,53,36
2011,32,Newcastle,6,53,4,46,42
2011,32,Everton,7,43,0,32,32
2011,32,Liverpool,8,42,3,36,33
2011,32,Sunderland,9,41,5,42,37
2011,32,Fulham,10,39,-3,39,42
2011,32,Swansea,11,39,-4,35,39
2011,32,Norwich,12,39,-7,42,49
2011,32,Stoke City,13,38,-14,29,43
2011,32,West Brom,14,36,-7,36,43
2011,32,Aston Villa,15,33,-10,34,44
2011,32,Bolton,16,32,-23,38,61
2011,32,QPR,17,28,-19,35,54
2011,32,Blackburn,18,28,-21,43,64
2011,32,Wigan,19,28,-26,29,55
2011,32,Wolves,20,22,-35,33,68
2011,33,Man Utd,1,79,51,78,27
2011,33,Man City,2,71,49,75,26
2011,33,Arsenal,3,61,22,63,41
2011,33,Spurs,4,59,20,56,36
2011,33,Chelsea,5,56,18,55,37
2011,33,Newcastle,6,56,6,48,42
2011,33,Everton,7,44,0,34,34
2011,33,Liverpool,8,43,3,37,34
2011,33,Sunderland,9,42,5,42,37
2011,33,Fulham,10,42,0,42,42
2011,33,Stoke City,11,41,-13,31,44
2011,33,Norwich,12,40,-7,44,51
2011,33,West Brom,13,39,-4,39,43
2011,33,Swansea,14,39,-6,35,41
2011,33,Aston Villa,15,34,-10,35,45
2011,33,Bolton,16,32,-26,38,64
2011,33,QPR,17,28,-21,35,56
2011,33,Blackburn,18,28,-24,43,67
2011,33,Wigan,19,28,-27,30,57
2011,33,Wolves,20,22,-36,34,70
2011,34,Man Utd,1,79,50,78,28
2011,34,Man City,2,74,53,79,26
2011,34,Arsenal,3,64,25,66,41
2011,34,Spurs,4,59,19,57,38
2011,34,Newcastle,5,59,8,50,42
2011,34,Chelsea,6,57,18,56,38
2011,34,Everton,7,47,4,38,34
2011,34,Liverpool,8,46,4,40,36
2011,34,Fulham,9,43,0,43,43
2011,34,Norwich,10,43,-6,46,52
2011,34,Sunderland,11,42,1,42,41
2011,34,Stoke City,12,42,-13,32,45
2011,34,West Brom,13,39,-8,39,47
2011,34,Swansea,14,39,-9,35,44
2011,34,Aston Villa,15,35,-10,36,46
2011,34,Bolton,16,32,-28,38,66
2011,34,QPR,17,31,-18,38,56
2011,34,Wigan,18,31,-26,31,57
2011,34,Blackburn,19,28,-25,45,70
2011,34,Wolves,20,22,-39,34,73
2011,35,Man Utd,1,82,54,82,28
2011,35,Man City,2,77,58,85,27
2011,35,Arsenal,3,64,24,67,43
2011,35,Spurs,4,62,22,61,39
2011,35,Newcastle,5,62,10,52,42
2011,35,Chelsea,6,57,16,56,40
2011,35,Everton,7,48,4,39,35
2011,35,Liverpool,8,46,3,40,37
2011,35,Fulham,9,46,1,44,43
2011,35,Sunderland,10,43,1,42,41
2011,35,Norwich,11,43,-11,47,58
2011,35,Stoke City,12,43,-13,33,46
2011,35,Swansea,13,42,-6,38,44
2011,35,West Brom,14,42,-7,40,47
2011,35,Aston Villa,15,35,-14,36,50
2011,35,Wigan,16,34,-25,33,58
2011,35,Bolton,17,32,-31,39,70
2011,35,QPR,18,31,-19,38,57
2011,35,Blackburn,19,28,-28,45,73
2011,35,Wolves,20,23,-39,34,73
2011,36,Man Utd,1,83,54,86,32
2011,36,Man City,2,80,60,87,27
2011,36,Arsenal,3,65,24,67,43
2011,36,Newcastle,4,65,13,55,42
2011,36,Spurs,5,62,21,61,40
2011,36,Chelsea,6,58,16,56,40
2011,36,Everton,7,49,4,43,39
2011,36,Fulham,8,49,2,46,44
2011,36,Liverpool,9,46,2,40,38
2011,36,West Brom,10,45,-6,41,47
2011,36,Sunderland,11,44,1,42,41
2011,36,Swansea,12,43,-6,39,45
2011,36,Norwich,13,43,-13,47,60
2011,36,Stoke City,14,43,-16,33,49
2011,36,Aston Villa,15,36,-14,36,50
2011,36,QPR,16,34,-18,39,57
2011,36,Wigan,17,34,-26,34,60
2011,36,Bolton,18,33,-31,40,71
2011,36,Blackburn,19,31,-26,47,73
2011,36,Wolves,20,23,-41,34,75
2011,37,Man City,1,83,61,88,27
2011,37,Man Utd,2,83,53,86,33
2011,37,Arsenal,3,66,24,68,44
2011,37,Spurs,4,65,23,63,40
2011,37,Newcastle,5,65,9,55,46
2011,37,Chelsea,6,61,21,62,41
2011,37,Everton,7,52,8,47,39
2011,37,Liverpool,8,49,5,43,38
2011,37,Fulham,9,49,-2,46,48
2011,37,West Brom,10,46,-6,41,47
2011,37,Sunderland,11,45,1,44,43
2011,37,Swansea,12,44,-6,43,49
2011,37,Stoke City,13,44,-16,34,50
2011,37,Norwich,14,43,-16,47,63
2011,37,Aston Villa,15,37,-14,36,50
2011,37,Wigan,16,37,-22,38,60
2011,37,QPR,17,34,-23,40,63
2011,37,Bolton,18,34,-31,42,73
2011,37,Blackburn,19,31,-28,47,75
2011,37,Wolves,20,24,-41,38,79
2011,38,Man City,1,86,63,90,27
2011,38,Man Utd,2,86,55,88,33
2011,38,Arsenal,3,67,24,71,47
2011,38,Spurs,4,66,23,64,41
2011,38,Newcastle,5,65,7,55,48
2011,38,Chelsea,6,61,18,63,45
2011,38,Everton,7,53,8,47,39
2011,38,Liverpool,8,52,8,47,39
2011,38,Fulham,9,52,-1,48,49
2011,38,West Brom,10,47,-6,43,49
2011,38,Sunderland,11,45,0,45,45
2011,38,Swansea,12,44,-8,43,51
2011,38,Norwich,13,44,-16,50,66
2011,38,Stoke City,14,44,-17,34,51
2011,38,Wigan,15,40,-21,39,60
2011,38,Aston Villa,16,38,-14,37,51
2011,38,QPR,17,37,-22,41,63
2011,38,Bolton,18,35,-31,44,75
2011,38,Blackburn,19,31,-29,47,76
2011,38,Wolves,20,25,-41,38,79
2011,39,Man City,1,89,64,93,29
2011,39,Man Utd,2,89,56,89,33
2011,39,Arsenal,3,70,25,74,49
2011,39,Spurs,4,69,25,66,41
2011,39,Newcastle,5,65,5,56,51
2011,39,Chelsea,6,64,19,65,46
2011,39,Everton,7,56,10,50,40
2011,39,Liverpool,8,52,7,47,40
2011,39,Fulham,9,52,-3,48,51
2011,39,West Brom,10,47,-7,45,52
2011,39,Swansea,11,47,-7,44,51
2011,39,Norwich,12,47,-14,52,66
2011,39,Sunderland,13,45,-1,45,46
2011,39,Stoke City,14,45,-17,36,53
2011,39,Wigan,15,43,-20,42,62
2011,39,Aston Villa,16,38,-16,37,53
2011,39,QPR,17,37,-23,43,66
2011,39,Bolton,18,36,-31,46,77
2011,39,Blackburn,19,31,-30,48,78
2011,39,Wolves,20,25,-42,40,82
2012,2,Fulham,1,3,5,5,0
2012,2,Swansea,2,3,5,5,0
2012,2,West Brom,3,3,3,3,0
2012,2,Chelsea,4,3,2,2,0
2012,2,Man City,5,3,1,3,2
2012,2,Newcastle,6,3,1,2,1
2012,2,Everton,7,3,1,1,0
2012,2,West Ham,8,3,1,1,0
2012,2,Stoke City,9,1,0,1,1
2012,2,Reading,10,1,0,1,1
2012,2,Arsenal,11,1,0,0,0
2012,2,Sunderland,12,1,0,0,0
2012,2,Southampton,13,0,-1,2,3
2012,2,Spurs,14,0,-1,1,2
2012,2,Aston Villa,15,0,-1,0,1
2012,2,Man Utd,16,0,-1,0,1
2012,2,Wigan,17,0,-2,0,2
2012,2,Liverpool,18,0,-3,0,3
2012,2,Norwich,19,0,-5,0,5
2012,2,QPR,20,0,-5,0,5
2012,3,Swansea,1,6,8,8,0
2012,3,Chelsea,2,6,4,4,0
2012,3,Everton,3,6,3,4,1
2012,3,West Brom,4,4,3,4,1
2012,3,Sunderland,5,4,3,3,0
2012,3,Man City,6,4,1,5,4
2012,3,Fulham,7,3,4,7,3
2012,3,Man Utd,8,3,0,3,3
2012,3,Wigan,9,3,0,2,2
2012,3,Newcastle,10,3,-1,2,3
2012,3,West Ham,11,3,-2,1,3
2012,3,Stoke City,12,2,0,1,1
2012,3,Arsenal,13,2,0,0,0
2012,3,Spurs,14,1,-1,2,3
2012,3,Liverpool,15,1,-3,2,5
2012,3,Reading,16,1,-3,1,4
2012,3,Norwich,17,1,-5,1,6
2012,3,QPR,18,1,-5,1,6
2012,3,Southampton,19,0,-3,2,5
2012,3,Aston Villa,20,0,-3,1,4
2012,4,Chelsea,1,9,6,8,2
2012,4,Swansea,2,7,8,10,2
2012,4,West Brom,3,7,5,6,1
2012,4,Man City,4,7,3,8,5
2012,4,Man Utd,5,6,1,6,5
2012,4,Everton,6,6,1,4,3
2012,4,West Ham,7,6,1,4,3
2012,4,Sunderland,8,5,3,5,2
2012,4,Arsenal,9,5,2,2,0
2012,4,Wigan,10,4,0,4,4
2012,4,Newcastle,11,4,-1,3,4
2012,4,Fulham,12,3,1,7,6
2012,4,Stoke City,13,3,0,3,3
2012,4,Spurs,14,2,-1,3,4
2012,4,Norwich,15,2,-5,2,7
2012,4,Aston Villa,16,1,-3,2,5
2012,4,Reading,17,1,-5,3,8
2012,4,Liverpool,18,1,-5,2,7
2012,4,QPR,19,1,-7,2,9
2012,4,Southampton,20,0,-4,4,8
2012,5,Chelsea,1,10,6,8,2
2012,5,Man Utd,2,9,5,10,5
2012,5,Arsenal,3,8,7,8,1
2012,5,Man City,4,8,3,9,6
2012,5,Swansea,5,7,6,10,4
2012,5,West Brom,6,7,2,6,4
2012,5,Everton,7,7,1,6,5
2012,5,West Ham,8,7,1,4,3
2012,5,Fulham,9,6,4,10,6
2012,5,Sunderland,10,6,3,6,3
2012,5,Spurs,11,5,1,6,5
2012,5,Newcastle,12,5,-1,5,6
2012,5,Stoke City,13,4,0,4,4
2012,5,Aston Villa,14,4,-1,4,5
2012,5,Wigan,15,4,-4,4,8
2012,5,Norwich,16,3,-5,2,7
2012,5,Liverpool,17,2,-5,3,8
2012,5,QPR,18,2,-7,2,9
2012,5,Reading,19,1,-7,4,11
2012,5,Southampton,20,0,-9,5,14
2012,6,Chelsea,1,13,7,9,2
2012,6,Man Utd,2,12,6,12,6
2012,6,Everton,3,10,4,9,5
2012,6,West Brom,4,10,3,7,4
2012,6,Arsenal,5,9,7,9,2
2012,6,Fulham,6,9,5,12,7
2012,6,Man City,7,9,3,10,7
2012,6,Spurs,8,8,2,8,6
2012,6,West Ham,9,8,1,5,4
2012,6,Newcastle,10,8,0,6,6
2012,6,Swansea,11,7,3,10,7
2012,6,Sunderland,12,7,3,7,4
2012,6,Stoke City,13,4,-1,4,5
2012,6,Aston Villa,14,4,-4,5,9
2012,6,Wigan,15,4,-5,5,10
2012,6,Southampton,16,3,-6,9,15
2012,6,Norwich,17,3,-6,2,8
2012,6,Liverpool,18,2,-6,4,10
2012,6,QPR,19,2,-8,3,11
2012,6,Reading,20,1,-8,4,12
2012,7,Chelsea,1,16,8,11,3
2012,7,Everton,2,13,6,12,6
2012,7,Man Utd,3,12,5,14,9
2012,7,Man City,4,12,4,12,8
2012,7,Spurs,5,11,3,11,8
2012,7,West Brom,6,11,3,8,5
2012,7,West Ham,7,11,2,7,5
2012,7,Sunderland,8,10,4,8,4
2012,7,Arsenal,9,9,6,10,4
2012,7,Fulham,10,9,4,13,9
2012,7,Newcastle,11,9,0,8,8
2012,7,Swansea,12,7,1,10,9
2012,7,Stoke City,13,7,1,6,5
2012,7,Liverpool,14,5,-3,9,12
2012,7,Aston Villa,15,5,-4,6,10
2012,7,Wigan,16,4,-6,5,11
2012,7,Southampton,17,3,-8,10,18
2012,7,Norwich,18,3,-9,4,13
2012,7,Reading,19,2,-8,6,14
2012,7,QPR,20,2,-9,4,13
2012,8,Chelsea,1,19,11,15,4
2012,8,Man Utd,2,15,8,17,9
2012,8,Man City,3,15,7,15,8
2012,8,Everton,4,14,6,14,8
2012,8,Spurs,5,14,5,13,8
2012,8,West Brom,6,14,4,11,7
2012,8,Arsenal,7,12,8,13,5
2012,8,West Ham,8,11,0,8,8
2012,8,Fulham,9,10,4,15,11
2012,8,Sunderland,10,10,1,8,7
2012,8,Newcastle,11,9,-3,8,11
2012,8,Swansea,12,8,1,12,11
2012,8,Stoke City,13,8,1,6,5
2012,8,Liverpool,14,6,-3,9,12
2012,8,Wigan,15,5,-6,7,13
2012,8,Aston Villa,16,5,-6,6,12
2012,8,Southampton,17,4,-8,12,20
2012,8,Reading,18,3,-8,8,16
2012,8,Norwich,19,3,-12,5,17
2012,8,QPR,20,2,-10,6,16
2012,9,Chelsea,1,22,13,19,6
2012,9,Man Utd,2,18,10,21,11
2012,9,Man City,3,18,8,17,9
2012,9,Everton,4,15,6,15,9
2012,9,Spurs,5,14,3,15,12
2012,9,West Brom,6,14,3,12,9
2012,9,West Ham,7,14,3,12,9
2012,9,Fulham,8,13,5,16,11
2012,9,Arsenal,9,12,7,13,6
2012,9,Swansea,10,11,2,14,12
2012,9,Sunderland,11,11,1,9,8
2012,9,Newcastle,12,10,-3,9,12
2012,9,Liverpool,13,9,-2,10,12
2012,9,Stoke City,14,8,-1,8,9
2012,9,Norwich,15,6,-11,6,17
2012,9,Wigan,16,5,-7,8,15
2012,9,Aston Villa,17,5,-7,6,13
2012,9,Southampton,18,4,-11,13,24
2012,9,Reading,19,3,-9,8,17
2012,9,QPR,20,3,-10,7,17
2012,10,Chelsea,1,22,12,21,9
2012,10,Man Utd,2,21,11,24,13
2012,10,Man City,3,21,9,18,9
2012,10,Spurs,4,17,4,17,13
2012,10,Everton,5,16,6,17,11
2012,10,Arsenal,6,15,8,14,6
2012,10,Fulham,7,14,5,19,14
2012,10,West Brom,8,14,2,13,11
2012,10,West Ham,9,14,2,13,11
2012,10,Newcastle,10,13,-2,11,13
2012,10,Sunderland,11,12,1,9,8
2012,10,Swansea,12,11,1,14,13
2012,10,Liverpool,13,10,-2,12,14
2012,10,Stoke City,14,9,-1,8,9
2012,10,Wigan,15,8,-6,10,16
2012,10,Norwich,16,7,-11,7,18
2012,10,Aston Villa,17,6,-7,7,14
2012,10,Reading,18,4,-9,11,20
2012,10,Southampton,19,4,-12,14,26
2012,10,QPR,20,3,-11,7,18
2012,11,Man Utd,1,24,12,26,14
2012,11,Chelsea,2,23,12,22,10
2012,11,Man City,3,22,9,18,9
2012,11,Everton,4,17,6,19,13
2012,11,West Brom,5,17,4,15,11
2012,11,Spurs,6,17,3,17,14
2012,11,Arsenal,7,15,7,15,8
2012,11,Fulham,8,15,5,21,16
2012,11,West Ham,9,15,2,13,11
2012,11,Newcastle,10,14,-2,12,14
2012,11,Swansea,11,12,1,15,14
2012,11,Sunderland,12,12,0,9,9
2012,11,Liverpool,13,11,-2,13,15
2012,11,Wigan,14,11,-5,11,16
2012,11,Norwich,15,10,-10,8,18
2012,11,Stoke City,16,9,-2,8,10
2012,11,Aston Villa,17,9,-6,8,14
2012,11,Reading,18,5,-9,12,21
2012,11,QPR,19,4,-11,8,19
2012,11,Southampton,20,4,-14,14,28
2012,12,Man Utd,1,27,13,29,16
2012,12,Man City,2,25,10,20,10
2012,12,Chelsea,3,24,12,23,11
2012,12,Everton,4,20,7,21,14
2012,12,West Brom,5,20,5,17,12
2012,12,West Ham,6,18,3,14,11
2012,12,Spurs,7,17,2,18,16
2012,12,Arsenal,8,16,7,18,11
2012,12,Fulham,9,16,5,24,19
2012,12,Newcastle,10,14,-3,12,15
2012,12,Swansea,11,13,1,16,15
2012,12,Sunderland,12,12,-1,10,11
2012,12,Stoke City,13,12,-1,9,10
2012,12,Liverpool,14,12,-2,14,16
2012,12,Wigan,15,11,-6,12,18
2012,12,Norwich,16,11,-10,8,18
2012,12,Aston Villa,17,9,-7,10,17
2012,12,Reading,18,6,-9,12,21
2012,12,Southampton,19,5,-14,15,29
2012,12,QPR,20,4,-12,8,20
2012,13,Man City,1,28,15,25,10
2012,13,Man Utd,2,27,12,29,17
2012,13,Chelsea,3,24,11,24,13
2012,13,West Brom,4,23,6,19,13
2012,13,Everton,5,20,6,22,16
2012,13,Arsenal,6,19,10,23,13
2012,13,West Ham,7,19,3,15,12
2012,13,Spurs,8,17,-1,20,21
2012,13,Fulham,9,16,3,25,22
2012,13,Swansea,10,16,2,18,16
2012,13,Liverpool,11,15,1,17,16
2012,13,Sunderland,12,15,1,13,12
2012,13,Newcastle,13,14,-4,13,17
2012,13,Norwich,14,14,-9,9,18
2012,13,Stoke City,15,13,-1,10,11
2012,13,Wigan,16,11,-9,12,21
2012,13,Reading,17,9,-8,14,22
2012,13,Aston Villa,18,9,-12,10,22
2012,13,Southampton,19,8,-12,18,30
2012,13,QPR,20,4,-14,9,23
2012,14,Man Utd,1,30,14,32,18
2012,14,Man City,2,29,15,25,10
2012,14,West Brom,3,26,8,23,15
2012,14,Chelsea,4,25,11,24,13
2012,14,Everton,5,21,6,23,17
2012,14,Arsenal,6,20,10,23,13
2012,14,Spurs,7,20,1,23,22
2012,14,West Ham,8,19,1,16,15
2012,14,Swansea,9,17,2,18,16
2012,14,Fulham,10,16,2,25,23
2012,14,Liverpool,11,16,1,17,16
2012,14,Stoke City,12,16,0,11,11
2012,14,Sunderland,13,15,-1,15,16
2012,14,Norwich,14,15,-9,10,19
2012,14,Newcastle,15,14,-6,13,19
2012,14,Wigan,16,14,-8,15,23
2012,14,Southampton,17,11,-10,20,30
2012,14,Aston Villa,18,10,-12,10,22
2012,14,Reading,19,9,-9,16,25
2012,14,QPR,20,4,-16,10,26
2012,15,Man Utd,1,33,15,33,18
2012,15,Man City,2,32,17,27,10
2012,15,Chelsea,3,26,11,24,13
2012,15,West Brom,4,26,6,24,18
2012,15,Spurs,5,23,2,25,23
2012,15,Everton,6,22,6,24,18
2012,15,Arsenal,7,21,10,24,14
2012,15,Swansea,8,20,4,21,17
2012,15,Stoke City,9,19,1,13,12
2012,15,West Ham,10,19,0,16,16
2012,15,Fulham,11,17,2,25,23
2012,15,Liverpool,12,16,0,18,18
2012,15,Sunderland,13,16,-1,15,16
2012,15,Norwich,14,16,-9,11,20
2012,15,Newcastle,15,14,-7,14,21
2012,15,Wigan,16,14,-10,15,25
2012,15,Aston Villa,17,13,-11,11,22
2012,15,Southampton,18,12,-10,21,31
2012,15,Reading,19,9,-10,16,26
2012,15,QPR,20,5,-16,10,26
2012,16,Man Utd,1,36,16,37,21
2012,16,Man City,2,33,17,28,11
2012,16,Chelsea,3,26,9,25,16
2012,16,Spurs,4,26,5,28,23
2012,16,West Brom,5,26,5,24,19
2012,16,Everton,6,23,6,25,19
2012,16,Swansea,7,23,6,23,17
2012,16,West Ham,8,22,2,19,17
2012,16,Stoke City,9,22,2,14,12
2012,16,Arsenal,10,21,8,24,16
2012,16,Liverpool,11,19,1,19,18
2012,16,Norwich,12,19,-8,13,21
2012,16,Fulham,13,17,-1,25,26
2012,16,Newcastle,14,17,-4,17,21
2012,16,Sunderland,15,16,-2,16,18
2012,16,Aston Villa,16,14,-11,12,23
2012,16,Wigan,17,14,-13,15,28
2012,16,Southampton,18,12,-11,21,32
2012,16,Reading,19,9,-11,19,30
2012,16,QPR,20,6,-16,11,27
2012,17,Man Utd,1,39,17,40,23
2012,17,Man City,2,33,16,30,14
2012,17,Chelsea,3,29,11,28,17
2012,17,Everton,4,26,7,27,20
2012,17,Spurs,5,26,4,29,25
2012,17,West Brom,6,26,3,24,21
2012,17,Arsenal,7,24,10,26,16
2012,17,Swansea,8,23,5,26,21
2012,17,Stoke City,9,23,2,14,12
2012,17,Liverpool,10,22,2,22,20
2012,17,West Ham,11,22,1,21,20
2012,17,Norwich,12,22,-7,17,24
2012,17,Fulham,13,20,0,27,27
2012,17,Newcastle,14,17,-5,18,23
2012,17,Sunderland,15,16,-4,17,21
2012,17,Southampton,16,15,-10,22,32
2012,17,Aston Villa,17,15,-11,12,23
2012,17,Wigan,18,15,-13,17,30
2012,17,Reading,19,9,-12,19,31
2012,17,QPR,20,7,-16,13,29
2012,18,Man Utd,1,42,19,43,24
2012,18,Man City,2,36,18,33,15
2012,18,Chelsea,3,30,11,30,19
2012,18,Spurs,4,29,5,30,25
2012,18,Arsenal,5,27,13,31,18
2012,18,Everton,6,27,7,28,21
2012,18,West Brom,7,27,3,24,21
2012,18,Norwich,8,25,-6,19,25
2012,18,Stoke City,9,24,2,15,13
2012,18,Swansea,10,23,4,26,22
2012,18,West Ham,11,23,1,21,20
2012,18,Liverpool,12,22,0,23,23
2012,18,Fulham,13,20,-1,28,29
2012,18,Aston Villa,14,18,-9,15,24
2012,18,Newcastle,15,17,-7,19,26
2012,18,Sunderland,16,16,-6,18,24
2012,18,Southampton,17,16,-10,24,34
2012,18,Wigan,18,15,-14,18,32
2012,18,QPR,19,10,-15,15,30
2012,18,Reading,20,9,-15,21,36
2012,19,Man Utd,1,43,19,44,25
2012,19,Man City,2,39,19,34,15
2012,19,Chelsea,3,33,19,38,19
2012,19,Arsenal,4,30,14,32,18
2012,19,Everton,5,30,8,30,22
2012,19,Spurs,6,30,5,30,25
2012,19,West Brom,7,30,4,26,22
2012,19,Liverpool,8,25,4,27,23
2012,19,Stoke City,9,25,2,15,13
2012,19,Norwich,10,25,-7,20,27
2012,19,Swansea,11,24,4,27,23
2012,19,West Ham,12,23,0,22,22
2012,19,Fulham,13,20,-5,28,33
2012,19,Newcastle,14,20,-6,20,26
2012,19,Sunderland,15,19,-5,19,24
2012,19,Aston Villa,16,18,-17,15,32
2012,19,Southampton,17,16,-11,24,35
2012,19,Wigan,18,15,-15,18,33
2012,19,QPR,19,10,-16,15,31
2012,19,Reading,20,9,-16,21,37
2012,20,Man Utd,1,46,20,48,28
2012,20,Man City,2,39,18,34,16
2012,20,Chelsea,3,36,20,39,19
2012,20,Arsenal,4,33,18,37,19
2012,20,Spurs,5,33,9,34,25
2012,20,Everton,6,33,9,32,23
2012,20,West Brom,7,33,5,28,23
2012,20,Stoke City,8,28,4,18,14
2012,20,Swansea,9,25,4,27,23
2012,20,Liverpool,10,25,2,28,26
2012,20,Norwich,11,25,-8,20,28
2012,20,West Ham,12,23,-4,23,27
2012,20,Sunderland,13,22,-4,20,24
2012,20,Fulham,14,21,-5,29,34
2012,20,Newcastle,15,20,-7,23,30
2012,20,Aston Villa,16,18,-21,15,36
2012,20,Southampton,17,17,-11,25,36
2012,20,Wigan,18,15,-16,19,35
2012,20,Reading,19,10,-16,21,37
2012,20,QPR,20,10,-17,16,33
2012,21,Man Utd,1,49,22,50,28
2012,21,Man City,2,42,19,38,19
2012,21,Chelsea,3,39,21,41,20
2012,21,Arsenal,4,36,22,44,22
2012,21,Spurs,5,36,10,36,26
2012,21,Everton,6,33,8,33,25
2012,21,West Brom,7,33,3,28,25
2012,21,Stoke City,8,29,4,21,17
2012,21,Liverpool,9,28,5,31,26
2012,21,Swansea,10,28,5,29,24
2012,21,Norwich,11,25,-9,23,32
2012,21,West Ham,12,23,-5,23,28
2012,21,Sunderland,13,22,-5,21,26
2012,21,Fulham,14,21,-6,30,36
2012,21,Newcastle,15,20,-11,26,37
2012,21,Southampton,16,18,-11,28,39
2012,21,Wigan,17,18,-13,22,35
2012,21,Aston Villa,18,18,-24,15,39
2012,21,Reading,19,13,-15,22,37
2012,21,QPR,20,10,-20,16,36
2012,22,Man Utd,1,52,26,54,28
2012,22,Man City,2,45,22,41,19
2012,22,Chelsea,3,39,20,41,21
2012,22,Spurs,4,39,12,39,27
2012,22,Arsenal,5,37,22,45,23
2012,22,Everton,6,36,9,35,26
2012,22,West Brom,7,33,2,29,27
2012,22,Liverpool,8,31,8,34,26
2012,22,Swansea,9,29,5,31,26
2012,22,Stoke City,10,29,1,21,20
2012,22,West Ham,11,26,-4,25,29
2012,22,Norwich,12,25,-10,24,34
2012,22,Fulham,13,24,-5,32,37
2012,22,Sunderland,14,22,-8,21,29
2012,22,Newcastle,15,20,-12,27,39
2012,22,Southampton,16,19,-11,29,40
2012,22,Aston Villa,17,19,-24,17,41
2012,22,Wigan,18,18,-17,22,39
2012,22,Reading,19,13,-17,23,40
2012,22,QPR,20,13,-19,17,36
2012,23,Man Utd,1,55,27,56,29
2012,23,Man City,2,48,24,43,19
2012,23,Chelsea,3,42,24,45,21
2012,23,Spurs,4,40,12,39,27
2012,23,Arsenal,5,37,20,45,25
2012,23,Everton,6,37,9,35,26
2012,23,West Brom,7,33,1,31,30
2012,23,Liverpool,8,31,7,35,28
2012,23,Swansea,9,30,5,31,26
2012,23,Stoke City,10,29,-3,21,24
2012,23,West Ham,11,26,-7,25,32
2012,23,Norwich,12,26,-10,24,34
2012,23,Fulham,13,25,-5,33,38
2012,23,Sunderland,14,25,-5,24,29
2012,23,Southampton,15,22,-10,30,40
2012,23,Newcastle,16,21,-12,27,39
2012,23,Wigan,17,19,-17,23,40
2012,23,Aston Villa,18,19,-25,17,42
2012,23,Reading,19,16,-16,26,42
2012,23,QPR,20,14,-19,17,36
2012,24,Man Utd,1,56,27,57,30
2012,24,Man City,2,51,26,45,19
2012,24,Chelsea,3,45,25,47,22
2012,24,Spurs,4,41,12,40,28
2012,24,Everton,5,38,9,35,26
2012,24,Arsenal,6,37,19,46,27
2012,24,Liverpool,7,34,12,40,28
2012,24,West Brom,8,34,1,33,32
2012,24,Swansea,9,33,7,34,27
2012,24,Stoke City,10,29,-5,22,27
2012,24,Sunderland,11,28,-4,27,31
2012,24,West Ham,12,27,-7,26,33
2012,24,Norwich,13,26,-15,24,39
2012,24,Fulham,14,25,-7,33,40
2012,24,Southampton,15,23,-10,30,40
2012,24,Newcastle,16,21,-13,28,41
2012,24,Aston Villa,17,20,-25,19,44
2012,24,Reading,18,19,-15,28,43
2012,24,Wigan,19,19,-18,25,43
2012,24,QPR,20,15,-19,18,37
2012,25,Man Utd,1,59,28,59,31
2012,25,Man City,2,52,26,45,19
2012,25,Chelsea,3,46,25,49,24
2012,25,Spurs,4,42,12,41,29
2012,25,Everton,5,41,10,37,27
2012,25,Arsenal,6,38,19,48,29
2012,25,Liverpool,7,35,12,42,30
2012,25,Swansea,8,34,7,34,27
2012,25,West Brom,9,34,0,34,34
2012,25,Stoke City,10,30,-5,24,29
2012,25,Sunderland,11,29,-4,27,31
2012,25,Fulham,12,28,-5,36,41
2012,25,West Ham,13,27,-9,27,36
2012,25,Norwich,14,27,-15,25,40
2012,25,Newcastle,15,24,-12,30,42
2012,25,Southampton,16,23,-11,31,42
2012,25,Reading,17,20,-15,30,45
2012,25,Wigan,18,20,-18,27,45
2012,25,Aston Villa,19,20,-26,20,46
2012,25,QPR,20,16,-19,18,37
2012,26,Man Utd,1,62,29,60,31
2012,26,Man City,2,53,26,47,21
2012,26,Chelsea,3,46,24,51,27
2012,26,Spurs,4,45,13,42,29
2012,26,Everton,5,42,10,40,30
2012,26,Arsenal,6,41,20,49,29
2012,26,Liverpool,7,36,12,44,32
2012,26,Swansea,8,34,6,34,28
2012,26,West Brom,9,34,-1,34,35
2012,26,Stoke City,10,30,-6,24,30
2012,26,West Ham,11,30,-8,28,36
2012,26,Sunderland,12,29,-5,28,33
2012,26,Fulham,13,28,-6,36,42
2012,26,Norwich,14,28,-15,25,40
2012,26,Newcastle,15,27,-11,33,44
2012,26,Southampton,16,24,-11,33,44
2012,26,Reading,17,23,-14,32,46
2012,26,Wigan,18,21,-18,29,47
2012,26,Aston Villa,19,21,-26,23,49
2012,26,QPR,20,17,-19,18,37
2012,27,Man Utd,1,65,31,62,31
2012,27,Man City,2,53,24,48,24
2012,27,Chelsea,3,49,27,55,28
2012,27,Spurs,4,48,14,44,30
2012,27,Arsenal,5,44,21,50,29
2012,27,Everton,6,42,8,40,32
2012,27,Swansea,7,37,9,38,29
2012,27,West Brom,8,37,1,36,35
2012,27,Liverpool,9,36,10,44,34
2012,27,Stoke City,10,33,-5,26,31
2012,27,West Ham,11,30,-9,29,38
2012,27,Fulham,12,29,-6,36,42
2012,27,Sunderland,13,29,-6,28,34
2012,27,Norwich,14,29,-15,25,40
2012,27,Southampton,15,27,-9,36,45
2012,27,Newcastle,16,27,-12,34,46
2012,27,Aston Villa,17,24,-25,25,50
2012,27,Reading,18,23,-15,33,48
2012,27,Wigan,19,21,-21,30,51
2012,27,QPR,20,17,-22,19,41
2012,28,Man Utd,1,68,33,64,31
2012,28,Man City,2,56,26,50,24
2012,28,Spurs,3,51,15,47,32
2012,28,Chelsea,4,49,25,55,30
2012,28,Arsenal,5,47,22,52,30
2012,28,Everton,6,42,7,41,34
2012,28,West Brom,7,40,2,38,36
2012,28,Liverpool,8,39,15,49,34
2012,28,Swansea,9,37,4,38,34
2012,28,Stoke City,10,33,-6,26,32
2012,28,Fulham,11,32,-5,37,42
2012,28,Norwich,12,32,-14,27,41
2012,28,Newcastle,13,30,-10,38,48
2012,28,West Ham,14,30,-10,31,41
2012,28,Sunderland,15,29,-7,29,36
2012,28,Southampton,16,27,-11,38,49
2012,28,Wigan,17,24,-18,33,51
2012,28,Aston Villa,18,24,-26,26,52
2012,28,Reading,19,23,-18,33,51
2012,28,QPR,20,17,-24,19,43
2012,29,Man Utd,1,71,37,68,31
2012,29,Man City,2,59,27,51,24
2012,29,Spurs,3,54,16,49,33
2012,29,Chelsea,4,52,26,56,30
2012,29,Arsenal,5,47,21,53,32
2012,29,Everton,6,45,9,44,35
2012,29,Liverpool,7,42,19,53,34
2012,29,Swansea,8,40,5,39,34
2012,29,West Brom,9,40,1,38,37
2012,29,Fulham,10,33,-5,39,44
2012,29,Stoke City,11,33,-7,26,33
2012,29,West Ham,12,33,-9,32,41
2012,29,Norwich,13,32,-18,27,45
2012,29,Sunderland,14,30,-7,31,38
2012,29,Newcastle,15,30,-11,38,49
2012,29,Southampton,16,27,-12,39,51
2012,29,Wigan,17,24,-22,33,55
2012,29,Aston Villa,18,24,-27,26,53
2012,29,Reading,19,23,-20,34,54
2012,29,QPR,20,20,-23,21,44
2012,30,Man Utd,1,72,37,70,33
2012,30,Man City,2,62,28,52,24
2012,30,Chelsea,3,55,29,59,30
2012,30,Spurs,4,54,15,51,36
2012,30,Arsenal,5,48,21,53,32
2012,30,Everton,6,46,9,44,35
2012,30,Liverpool,7,45,20,56,36
2012,30,West Brom,8,43,2,40,38
2012,30,Swansea,9,40,4,40,36
2012,30,West Ham,10,34,-9,34,43
2012,30,Fulham,11,33,-8,39,47
2012,30,Stoke City,12,33,-8,27,35
2012,30,Newcastle,13,33,-10,40,50
2012,30,Norwich,14,33,-18,27,45
2012,30,Sunderland,15,30,-9,32,41
2012,30,Southampton,16,28,-12,39,51
2012,30,Aston Villa,17,27,-26,28,54
2012,30,Wigan,18,24,-23,33,56
2012,30,Reading,19,23,-21,35,56
2012,30,QPR,20,23,-21,24,45
2012,31,Man Utd,1,75,38,71,33
2012,31,Man City,2,62,26,52,26
2012,31,Chelsea,3,58,31,61,30
2012,31,Spurs,4,54,14,51,37
2012,31,Arsenal,5,51,23,55,32
2012,31,Everton,6,49,11,46,35
2012,31,Liverpool,7,45,18,57,39
2012,31,West Brom,8,44,2,40,38
2012,31,Swansea,9,40,2,40,38
2012,31,Fulham,10,36,-7,40,47
2012,31,Stoke City,11,34,-8,27,35
2012,31,West Ham,12,34,-11,34,45
2012,31,Norwich,13,34,-18,28,46
2012,31,Newcastle,14,33,-11,41,52
2012,31,Sunderland,15,31,-9,33,42
2012,31,Southampton,16,31,-10,42,52
2012,31,Aston Villa,17,30,-25,31,56
2012,31,Wigan,18,27,-22,35,57
2012,31,Reading,19,23,-22,35,57
2012,31,QPR,20,23,-22,26,48
2012,32,Man Utd,1,78,39,72,33
2012,32,Man City,2,65,30,56,26
2012,32,Chelsea,3,58,30,62,32
2012,32,Spurs,4,57,15,53,38
2012,32,Arsenal,5,54,26,59,33
2012,32,Everton,6,52,12,47,35
2012,32,Liverpool,7,48,19,59,40
2012,32,West Brom,8,44,0,41,41
2012,32,Swansea,9,40,1,41,40
2012,32,Fulham,10,39,-6,43,49
2012,32,West Ham,11,37,-9,37,46
2012,32,Southampton,12,34,-9,44,53
2012,32,Stoke City,13,34,-9,27,36
2012,32,Norwich,14,34,-19,28,47
2012,32,Newcastle,15,33,-15,41,56
2012,32,Sunderland,16,31,-10,33,43
2012,32,Wigan,17,30,-21,36,57
2012,32,Aston Villa,18,30,-26,32,58
2012,32,QPR,19,23,-23,28,51
2012,32,Reading,20,23,-25,36,61
2012,33,Man Utd,1,78,38,73,35
2012,33,Man City,2,68,31,58,27
2012,33,Chelsea,3,61,31,64,33
2012,33,Spurs,4,58,15,55,40
2012,33,Arsenal,5,57,27,61,34
2012,33,Everton,6,53,12,49,37
2012,33,Liverpool,7,49,19,59,40
2012,33,West Brom,8,44,-1,42,43
2012,33,Swansea,9,41,1,43,42
2012,33,Fulham,10,39,-7,43,50
2012,33,West Ham,11,38,-9,37,46
2012,33,Southampton,12,37,-7,46,53
2012,33,Newcastle,13,36,-14,42,56
2012,33,Norwich,14,35,-19,30,49
2012,33,Stoke City,15,34,-11,28,39
2012,33,Aston Villa,16,33,-24,35,59
2012,33,Sunderland,17,31,-11,34,45
2012,33,Wigan,18,31,-21,37,58
2012,33,QPR,19,24,-23,29,52
2012,33,Reading,20,23,-27,36,63
2012,34,Man Utd,1,81,40,75,35
2012,34,Man City,2,71,32,59,27
2012,34,Chelsea,3,62,31,66,35
2012,34,Arsenal,4,60,29,64,35
2012,34,Spurs,5,59,15,57,42
2012,34,Everton,6,56,14,51,37
2012,34,Liverpool,7,50,19,59,40
2012,34,Swansea,8,44,2,46,44
2012,34,West Brom,9,44,-2,42,44
2012,34,Fulham,10,40,-7,44,51
2012,34,West Ham,11,39,-9,38,47
2012,34,Southampton,12,38,-7,47,54
2012,34,Newcastle,13,36,-17,42,59
2012,34,Norwich,14,35,-21,31,52
2012,34,Sunderland,15,34,-8,37,45
2012,34,Stoke City,16,34,-13,28,41
2012,34,Aston Villa,17,34,-24,36,60
2012,34,Wigan,18,31,-22,39,61
2012,34,QPR,19,24,-25,29,54
2012,34,Reading,20,24,-27,36,63
2012,35,Man Utd,1,84,43,78,35
2012,35,Man City,2,71,30,60,30
2012,35,Chelsea,3,63,31,68,37
2012,35,Arsenal,4,63,30,65,35
2012,35,Spurs,5,62,17,60,43
2012,35,Everton,6,56,13,51,38
2012,35,Liverpool,7,51,19,61,42
2012,35,Swansea,8,45,2,46,44
2012,35,West Brom,9,45,-2,43,45
2012,35,West Ham,10,42,-7,40,47
2012,35,Fulham,11,40,-8,44,52
2012,35,Southampton,12,39,-7,47,54
2012,35,Norwich,13,38,-20,33,53
2012,35,Sunderland,14,37,-7,38,45
2012,35,Stoke City,15,37,-11,30,41
2012,35,Newcastle,16,37,-17,43,60
2012,35,Aston Villa,17,34,-27,36,63
2012,35,Wigan,18,31,-24,39,63
2012,35,QPR,19,24,-27,29,56
2012,35,Reading,20,24,-28,37,65
2012,36,Man Utd,1,85,43,79,36
2012,36,Man City,2,74,31,62,31
2012,36,Chelsea,3,66,33,70,37
2012,36,Arsenal,4,64,30,66,36
2012,36,Spurs,5,63,17,62,45
2012,36,Everton,6,59,14,52,38
2012,36,Liverpool,7,54,25,67,42
2012,36,West Brom,8,48,1,46,45
2012,36,Swansea,9,45,0,46,46
2012,36,West Ham,10,42,-8,41,49
2012,36,Fulham,11,40,-9,44,53
2012,36,Stoke City,12,40,-10,31,41
2012,36,Southampton,13,39,-10,47,57
2012,36,Norwich,14,38,-21,33,54
2012,36,Sunderland,15,37,-12,39,51
2012,36,Aston Villa,16,37,-22,42,64
2012,36,Newcastle,17,37,-23,43,66
2012,36,Wigan,18,32,-24,41,65
2012,36,QPR,19,25,-27,29,56
2012,36,Reading,20,25,-28,37,65
2012,37,Man Utd,1,85,42,79,37
2012,37,Man City,2,75,31,62,31
2012,37,Chelsea,3,69,34,71,37
2012,37,Arsenal,4,67,31,67,36
2012,37,Spurs,5,66,18,63,45
2012,37,Everton,6,60,14,52,38
2012,37,Liverpool,7,55,25,67,42
2012,37,West Brom,8,48,0,48,48
2012,37,Swansea,9,46,0,46,46
2012,37,West Ham,10,43,-8,41,49
2012,37,Stoke City,11,41,-10,32,42
2012,37,Fulham,12,40,-11,46,57
2012,37,Aston Villa,13,40,-21,44,65
2012,37,Southampton,14,39,-11,47,58
2012,37,Sunderland,15,38,-12,40,52
2012,37,Norwich,16,38,-22,34,56
2012,37,Newcastle,17,38,-23,43,66
2012,37,Wigan,18,35,-23,44,67
2012,37,Reading,19,28,-26,41,67
2012,37,QPR,20,25,-28,29,57
2012,38,Man Utd,1,88,43,81,38
2012,38,Man City,2,78,33,64,31
2012,38,Chelsea,3,72,35,73,38
2012,38,Arsenal,4,70,34,71,37
2012,38,Spurs,5,69,19,65,46
2012,38,Everton,6,63,16,54,38
2012,38,Liverpool,7,58,27,70,43
2012,38,West Brom,8,48,-4,48,52
2012,38,Swansea,9,46,-1,47,48
2012,38,West Ham,10,43,-10,41,51
2012,38,Stoke City,11,41,-11,33,44
2012,38,Norwich,12,41,-18,38,56
2012,38,Newcastle,13,41,-22,45,67
2012,38,Southampton,14,40,-11,48,59
2012,38,Fulham,15,40,-13,47,60
2012,38,Aston Villa,16,40,-22,45,67
2012,38,Sunderland,17,39,-12,41,53
2012,38,Wigan,18,35,-26,45,71
2012,38,Reading,19,28,-28,41,69
2012,38,QPR,20,25,-29,30,59
2012,39,Man Utd,1,89,43,86,43
2012,39,Man City,2,78,32,66,34
2012,39,Chelsea,3,75,36,75,39
2012,39,Arsenal,4,73,35,72,37
2012,39,Spurs,5,72,20,66,46
2012,39,Everton,6,63,15,55,40
2012,39,Liverpool,7,61,28,71,43
2012,39,West Brom,8,49,-4,53,57
2012,39,Swansea,9,46,-4,47,51
2012,39,West Ham,10,46,-8,45,53
2012,39,Norwich,11,44,-17,41,58
2012,39,Fulham,12,43,-10,50,60
2012,39,Stoke City,13,42,-11,34,45
2012,39,Southampton,14,41,-11,49,60
2012,39,Aston Villa,15,41,-22,47,69
2012,39,Newcastle,16,41,-23,45,68
2012,39,Sunderland,17,39,-13,41,54
2012,39,Wigan,18,36,-26,47,73
2012,39,Reading,19,28,-30,43,73
2012,39,QPR,20,25,-30,30,60
2013,2,Man City,1,3,4,4,0
2013,2,Man Utd,2,3,3,4,1
2013,2,Aston Villa,3,3,2,3,1
2013,2,Chelsea,4,3,2,2,0
2013,2,West Ham,5,3,2,2,0
2013,2,Spurs,6,3,1,1,0
2013,2,Liverpool,7,3,1,1,0
2013,2,Fulham,8,3,1,1,0
2013,2,Southampton,9,3,1,1,0
2013,2,Everton,10,1,0,2,2
2013,2,Norwich,11,1,0,2,2
2013,2,West Brom,12,0,-1,0,1
2013,2,Stoke City,13,0,-1,0,1
2013,2,Sunderland,14,0,-1,0,1
2013,2,Crystal Palace,15,0,-1,0,1
2013,2,Arsenal,16,0,-2,1,3
2013,2,Cardiff,17,0,-2,0,2
2013,2,Hull City,18,0,-2,0,2
2013,2,Swansea,19,0,-3,1,4
2013,2,Newcastle,20,0,-4,0,4
2013,3,Spurs,1,6,2,2,0
2013,3,Liverpool,2,6,2,2,0
2013,3,Man Utd,3,4,3,4,1
2013,3,Chelsea,4,4,2,2,0
2013,3,West Ham,5,4,2,2,0
2013,3,Southampton,6,4,1,2,1
2013,3,Man City,7,3,3,6,3
2013,3,Aston Villa,8,3,1,3,2
2013,3,Arsenal,9,3,0,4,4
2013,3,Stoke City,10,3,0,2,2
2013,3,Cardiff,11,3,-1,3,4
2013,3,Fulham,12,3,-1,2,3
2013,3,Hull City,13,3,-1,1,2
2013,3,Everton,14,2,0,2,2
2013,3,Norwich,15,1,-1,2,3
2013,3,Sunderland,16,1,-1,1,2
2013,3,West Brom,17,1,-1,0,1
2013,3,Newcastle,18,1,-4,0,4
2013,3,Crystal Palace,19,0,-2,1,3
2013,3,Swansea,20,0,-4,1,5
2013,4,Liverpool,1,9,3,3,0
2013,4,Chelsea,2,7,3,4,1
2013,4,Man City,3,6,5,8,3
2013,4,Arsenal,4,6,1,5,4
2013,4,Stoke City,5,6,1,3,2
2013,4,Spurs,6,6,1,2,1
2013,4,Man Utd,7,4,2,4,2
2013,4,West Ham,8,4,1,2,1
2013,4,Norwich,9,4,0,3,3
2013,4,Southampton,10,4,0,2,2
2013,4,Cardiff,11,4,-1,3,4
2013,4,Newcastle,12,4,-3,1,4
2013,4,Aston Villa,13,3,0,4,4
2013,4,Crystal Palace,14,3,0,4,4
2013,4,Everton,15,3,0,2,2
2013,4,Swansea,16,3,-2,3,5
2013,4,Fulham,17,3,-2,2,4
2013,4,Hull City,18,3,-3,1,4
2013,4,Sunderland,19,1,-3,2,5
2013,4,West Brom,20,1,-3,0,3
2013,5,Liverpool,1,10,3,5,2
2013,5,Arsenal,2,9,3,8,5
2013,5,Spurs,3,9,3,4,1
2013,5,Man City,4,7,5,8,3
2013,5,Man Utd,5,7,4,6,2
2013,5,Chelsea,6,7,2,4,2
2013,5,Stoke City,7,7,1,3,2
2013,5,Newcastle,8,7,-2,3,5
2013,5,Everton,9,6,1,3,2
2013,5,West Ham,10,5,1,2,1
2013,5,Southampton,11,5,0,2,2
2013,5,Cardiff,12,5,-1,4,5
2013,5,Swansea,13,4,-2,5,7
2013,5,Norwich,14,4,-2,3,5
2013,5,Fulham,15,4,-2,3,5
2013,5,Hull City,16,4,-3,2,5
2013,5,Aston Villa,17,3,-1,5,6
2013,5,Crystal Palace,18,3,-2,4,6
2013,5,West Brom,19,2,-3,1,4
2013,5,Sunderland,20,1,-5,3,8
2013,6,Arsenal,1,12,5,11,6
2013,6,Spurs,2,12,4,5,1
2013,6,Man City,3,10,8,12,4
2013,6,Chelsea,4,10,4,6,2
2013,6,Liverpool,5,10,2,5,3
2013,6,Everton,6,9,2,6,4
2013,6,Southampton,7,8,1,3,2
2013,6,Man Utd,8,7,1,7,6
2013,6,Swansea,9,7,0,7,7
2013,6,Stoke City,10,7,-1,4,5
2013,6,Hull City,11,7,-2,5,7
2013,6,Newcastle,12,7,-3,5,8
2013,6,Aston Villa,13,6,0,6,6
2013,6,West Brom,14,5,0,4,4
2013,6,West Ham,15,5,0,4,4
2013,6,Cardiff,16,5,-2,4,6
2013,6,Norwich,17,4,-3,3,6
2013,6,Fulham,18,4,-4,3,7
2013,6,Crystal Palace,19,3,-4,4,8
2013,6,Sunderland,20,1,-8,3,11
2013,7,Arsenal,1,15,6,13,7
2013,7,Liverpool,2,13,4,8,4
2013,7,Spurs,3,13,4,6,2
2013,7,Everton,4,12,3,9,6
2013,7,Chelsea,5,11,4,7,3
2013,7,Southampton,6,11,3,5,2
2013,7,Man City,7,10,7,14,7
2013,7,Hull City,8,10,-1,6,7
2013,7,Aston Villa,9,9,1,9,8
2013,7,West Brom,10,8,1,6,5
2013,7,Cardiff,11,8,-1,6,7
2013,7,Man Utd,12,7,0,8,8
2013,7,Swansea,13,7,-1,8,9
2013,7,Norwich,14,7,-2,4,6
2013,7,Stoke City,15,7,-2,4,6
2013,7,Newcastle,16,7,-4,7,11
2013,7,West Ham,17,5,-1,4,5
2013,7,Fulham,18,4,-5,4,9
2013,7,Crystal Palace,19,3,-6,4,10
2013,7,Sunderland,20,1,-10,4,14
2013,8,Arsenal,1,16,6,14,8
2013,8,Liverpool,2,16,6,11,5
2013,8,Chelsea,3,14,6,10,4
2013,8,Southampton,4,14,5,7,2
2013,8,Man City,5,13,9,17,8
2013,8,Spurs,6,13,1,6,5
2013,8,Everton,7,12,1,10,9
2013,8,Hull City,8,11,-1,6,7
2013,8,Man Utd,9,10,1,10,9
2013,8,Aston Villa,10,10,1,9,8
2013,8,Newcastle,11,10,-3,9,12
2013,8,West Brom,12,9,1,7,6
2013,8,West Ham,13,8,2,7,5
2013,8,Cardiff,14,8,-2,7,9
2013,8,Swansea,15,7,-3,8,11
2013,8,Stoke City,16,7,-3,4,7
2013,8,Norwich,17,7,-4,5,9
2013,8,Fulham,18,7,-4,5,9
2013,8,Crystal Palace,19,3,-8,5,13
2013,8,Sunderland,20,1,-11,5,16
2013,9,Arsenal,1,19,9,18,9
2013,9,Chelsea,2,17,9,14,5
2013,9,Liverpool,3,17,6,13,7
2013,9,Man City,4,16,11,20,9
2013,9,Spurs,5,16,3,8,5
2013,9,Southampton,6,15,5,8,3
2013,9,Everton,7,15,2,12,10
2013,9,Man Utd,8,11,1,11,10
2013,9,Hull City,9,11,-2,7,9
2013,9,Newcastle,10,11,-3,11,14
2013,9,Swansea,11,10,1,12,11
2013,9,West Brom,12,10,1,7,6
2013,9,Fulham,13,10,-1,9,10
2013,9,Aston Villa,14,10,-1,9,10
2013,9,West Ham,15,8,0,8,8
2013,9,Stoke City,16,8,-3,4,7
2013,9,Cardiff,17,8,-5,8,13
2013,9,Norwich,18,7,-7,6,13
2013,9,Crystal Palace,19,3,-11,6,17
2013,9,Sunderland,20,1,-15,5,20
2013,10,Arsenal,1,22,11,20,9
2013,10,Chelsea,2,20,10,16,6
2013,10,Liverpool,3,20,9,17,8
2013,10,Spurs,4,19,4,9,5
2013,10,Southampton,5,18,7,10,3
2013,10,Everton,6,18,4,14,10
2013,10,Man City,7,16,10,21,11
2013,10,Man Utd,8,14,2,14,12
2013,10,Swansea,9,11,1,12,11
2013,10,Hull City,10,11,-3,7,10
2013,10,Newcastle,11,11,-4,12,16
2013,10,West Brom,12,10,-2,8,10
2013,10,Fulham,13,10,-3,9,12
2013,10,Aston Villa,14,10,-3,9,12
2013,10,West Ham,15,9,0,8,8
2013,10,Cardiff,16,9,-5,8,13
2013,10,Stoke City,17,8,-4,6,10
2013,10,Norwich,18,8,-7,6,13
2013,10,Sunderland,19,4,-14,7,21
2013,10,Crystal Palace,20,3,-13,6,19
2013,11,Arsenal,1,25,13,22,9
2013,11,Chelsea,2,20,8,16,8
2013,11,Liverpool,3,20,7,17,10
2013,11,Spurs,4,20,4,9,5
2013,11,Man City,5,19,17,28,11
2013,11,Southampton,6,19,7,11,4
2013,11,Everton,7,19,4,14,10
2013,11,Man Utd,8,17,4,17,13
2013,11,Newcastle,9,14,-2,14,16
2013,11,Hull City,10,14,-2,8,10
2013,11,West Brom,11,13,0,10,10
2013,11,Cardiff,12,12,-4,9,13
2013,11,Swansea,13,11,0,12,12
2013,11,Aston Villa,14,11,-3,9,12
2013,11,West Ham,15,10,0,8,8
2013,11,Fulham,16,10,-5,10,15
2013,11,Stoke City,17,9,-4,7,11
2013,11,Norwich,18,8,-14,6,20
2013,11,Sunderland,19,4,-15,7,22
2013,11,Crystal Palace,20,3,-15,6,21
2013,12,Arsenal,1,25,12,22,10
2013,12,Liverpool,2,23,11,21,10
2013,12,Southampton,3,22,10,15,5
2013,12,Chelsea,4,21,8,18,10
2013,12,Man Utd,5,20,5,18,13
2013,12,Everton,6,20,4,14,10
2013,12,Spurs,7,20,3,9,6
2013,12,Man City,8,19,16,28,12
2013,12,Newcastle,9,17,-1,15,16
2013,12,West Brom,10,14,0,12,12
2013,12,Aston Villa,11,14,-1,11,12
2013,12,Hull City,12,14,-5,9,14
2013,12,Swansea,13,12,0,15,15
2013,12,Cardiff,14,12,-6,9,15
2013,12,Norwich,15,11,-12,9,21
2013,12,West Ham,16,10,-2,9,11
2013,12,Stoke City,17,10,-4,10,14
2013,12,Fulham,18,10,-9,10,19
2013,12,Sunderland,19,7,-14,8,22
2013,12,Crystal Palace,20,4,-15,6,21
2013,13,Arsenal,1,28,14,24,10
2013,13,Liverpool,2,24,11,24,13
2013,13,Chelsea,3,24,11,21,10
2013,13,Man City,4,22,22,34,12
2013,13,Southampton,5,22,8,15,7
2013,13,Man Utd,6,21,5,20,15
2013,13,Everton,7,21,4,17,13
2013,13,Newcastle,8,20,0,17,17
2013,13,Spurs,9,20,-3,9,12
2013,13,Swansea,10,15,1,17,16
2013,13,West Brom,11,15,0,14,14
2013,13,Aston Villa,12,15,-1,13,14
2013,13,Hull City,13,14,-6,9,15
2013,13,Stoke City,14,13,-2,12,14
2013,13,Cardiff,15,13,-6,11,17
2013,13,Norwich,16,11,-13,10,23
2013,13,West Ham,17,10,-5,9,14
2013,13,Fulham,18,10,-10,11,21
2013,13,Crystal Palace,19,7,-14,7,21
2013,13,Sunderland,20,7,-16,8,24
2013,14,Arsenal,1,31,17,27,10
2013,14,Chelsea,2,27,13,24,11
2013,14,Man City,3,25,25,37,12
2013,14,Liverpool,4,24,9,25,16
2013,14,Everton,5,24,8,21,13
2013,14,Newcastle,6,23,1,19,18
2013,14,Southampton,7,22,6,16,10
2013,14,Man Utd,8,22,5,22,17
2013,14,Spurs,9,21,-3,11,14
2013,14,Hull City,10,17,-4,12,16
2013,14,Aston Villa,11,16,-1,13,14
2013,14,West Brom,12,15,-1,15,16
2013,14,Swansea,13,15,-2,17,19
2013,14,Norwich,14,14,-12,11,23
2013,14,West Ham,15,13,-2,12,14
2013,14,Stoke City,16,13,-6,12,18
2013,14,Cardiff,17,13,-9,11,20
2013,14,Fulham,18,10,-13,11,24
2013,14,Sunderland,19,8,-16,8,24
2013,14,Crystal Palace,20,7,-15,7,22
2013,15,Arsenal,1,34,19,29,10
2013,15,Chelsea,2,30,14,28,14
2013,15,Man City,3,28,26,40,14
2013,15,Liverpool,4,27,13,30,17
2013,15,Everton,5,27,9,22,13
2013,15,Spurs,6,24,-2,13,15
2013,15,Newcastle,7,23,-2,19,21
2013,15,Southampton,8,22,5,18,13
2013,15,Man Utd,9,22,4,22,18
2013,15,Aston Villa,10,19,0,16,16
2013,15,Swansea,11,18,1,20,19
2013,15,Hull City,12,17,-6,12,18
2013,15,West Brom,13,15,-2,17,19
2013,15,Stoke City,14,14,-6,12,18
2013,15,Cardiff,15,14,-9,11,20
2013,15,Norwich,16,14,-16,12,28
2013,15,West Ham,17,13,-3,12,15
2013,15,Fulham,18,10,-14,12,26
2013,15,Crystal Palace,19,10,-14,8,22
2013,15,Sunderland,20,8,-17,11,28
2013,16,Arsenal,1,35,19,30,11
2013,16,Liverpool,2,30,16,34,18
2013,16,Chelsea,3,30,13,30,17
2013,16,Man City,4,29,26,41,15
2013,16,Everton,5,28,9,23,14
2013,16,Spurs,6,27,-1,15,16
2013,16,Newcastle,7,26,-1,20,21
2013,16,Southampton,8,23,5,19,14
2013,16,Man Utd,9,22,3,22,19
2013,16,Swansea,10,19,1,21,20
2013,16,Aston Villa,11,19,-2,16,18
2013,16,Hull City,12,18,-6,13,19
2013,16,Stoke City,13,17,-5,15,20
2013,16,Norwich,14,17,-14,14,28
2013,16,West Brom,15,15,-4,17,21
2013,16,Cardiff,16,14,-11,11,22
2013,16,West Ham,17,13,-6,13,19
2013,16,Fulham,18,13,-12,14,26
2013,16,Crystal Palace,19,13,-12,10,22
2013,16,Sunderland,20,8,-18,12,30
2013,17,Arsenal,1,35,16,33,17
2013,17,Liverpool,2,33,21,39,18
2013,17,Chelsea,3,33,14,32,18
2013,17,Man City,4,32,29,47,18
2013,17,Everton,5,31,12,27,15
2013,17,Newcastle,6,27,-1,21,22
2013,17,Spurs,7,27,-6,15,21
2013,17,Man Utd,8,25,6,25,19
2013,17,Southampton,9,24,5,20,15
2013,17,Swansea,10,20,1,22,21
2013,17,Aston Villa,11,19,-5,16,21
2013,17,Hull City,12,19,-6,13,19
2013,17,Stoke City,13,18,-5,15,20
2013,17,Norwich,14,18,-14,15,29
2013,17,Cardiff,15,17,-10,12,22
2013,17,West Brom,16,15,-5,17,22
2013,17,West Ham,17,14,-6,13,19
2013,17,Crystal Palace,18,13,-13,11,24
2013,17,Fulham,19,13,-15,15,30
2013,17,Sunderland,20,9,-18,12,30
2013,18,Liverpool,1,36,23,42,19
2013,18,Arsenal,2,36,16,33,17
2013,18,Man City,3,35,31,51,20
2013,18,Chelsea,4,34,14,32,18
2013,18,Everton,5,34,13,29,16
2013,18,Newcastle,6,30,2,24,22
2013,18,Spurs,7,30,-5,18,23
2013,18,Man Utd,8,28,8,28,20
2013,18,Southampton,9,24,4,22,18
2013,18,Stoke City,10,21,-4,17,21
2013,18,Swansea,11,20,0,23,23
2013,18,Hull City,12,20,-6,14,20
2013,18,Aston Villa,13,19,-6,17,23
2013,18,Norwich,14,19,-14,15,29
2013,18,Cardiff,15,17,-12,13,25
2013,18,West Brom,16,16,-5,18,23
2013,18,West Ham,17,14,-8,14,22
2013,18,Crystal Palace,18,13,-16,11,27
2013,18,Fulham,19,13,-17,17,34
2013,18,Sunderland,20,10,-18,12,30
2013,19,Arsenal,1,39,18,36,18
2013,19,Man City,2,38,32,53,21
2013,19,Chelsea,3,37,15,33,18
2013,19,Liverpool,4,36,22,43,21
2013,19,Everton,5,34,12,29,17
2013,19,Newcastle,6,33,6,29,23
2013,19,Man Utd,7,31,9,31,22
2013,19,Spurs,8,31,-5,19,24
2013,19,Southampton,9,27,7,25,18
2013,19,Stoke City,10,21,-8,18,26
2013,19,Swansea,11,20,-1,23,24
2013,19,Hull City,12,20,-7,16,23
2013,19,Aston Villa,13,19,-7,17,24
2013,19,Norwich,14,19,-15,16,31
2013,19,West Brom,15,17,-5,19,24
2013,19,Cardiff,16,17,-15,13,28
2013,19,Crystal Palace,17,16,-15,12,27
2013,19,Fulham,18,16,-16,19,35
2013,19,West Ham,19,14,-10,15,25
2013,19,Sunderland,20,13,-17,13,30
2013,20,Arsenal,1,42,19,37,18
2013,20,Man City,2,41,33,54,21
2013,20,Chelsea,3,40,16,35,19
2013,20,Everton,4,37,13,31,18
2013,20,Liverpool,5,36,21,44,23
2013,20,Man Utd,6,34,10,32,22
2013,20,Spurs,7,34,-2,22,24
2013,20,Newcastle,8,33,5,29,24
2013,20,Southampton,9,27,6,26,20
2013,20,Hull City,10,23,-1,22,23
2013,20,Swansea,11,21,-1,24,25
2013,20,Stoke City,12,21,-11,18,29
2013,20,Aston Villa,13,20,-7,18,25
2013,20,Norwich,14,19,-16,16,32
2013,20,West Brom,15,18,-5,22,27
2013,20,Cardiff,16,18,-15,15,30
2013,20,Crystal Palace,17,16,-16,12,28
2013,20,Fulham,18,16,-22,19,41
2013,20,West Ham,19,15,-10,18,28
2013,20,Sunderland,20,14,-17,15,32
2013,21,Arsenal,1,45,21,39,18
2013,21,Man City,2,44,34,57,23
2013,21,Chelsea,3,43,19,38,19
2013,21,Liverpool,4,39,23,46,23
2013,21,Everton,5,38,13,32,19
2013,21,Spurs,6,37,-1,24,25
2013,21,Man Utd,7,34,9,33,24
2013,21,Newcastle,8,33,4,29,25
2013,21,Southampton,9,27,3,26,23
2013,21,Hull City,10,23,-3,22,25
2013,21,Aston Villa,11,23,-6,19,25
2013,21,Stoke City,12,22,-11,19,30
2013,21,Swansea,13,21,-2,26,28
2013,21,West Brom,14,21,-4,23,27
2013,21,Norwich,15,20,-16,17,33
2013,21,Fulham,16,19,-21,21,42
2013,21,Cardiff,17,18,-17,15,32
2013,21,Crystal Palace,18,17,-16,13,29
2013,21,West Ham,19,15,-11,19,30
2013,21,Sunderland,20,14,-18,15,33
2013,22,Arsenal,1,48,22,41,19
2013,22,Man City,2,47,36,59,23
2013,22,Chelsea,3,46,21,40,19
2013,22,Liverpool,4,42,25,51,26
2013,22,Everton,5,41,15,34,19
2013,22,Spurs,6,40,1,26,25
2013,22,Man Utd,7,37,11,35,24
2013,22,Newcastle,8,33,2,29,27
2013,22,Southampton,9,30,4,27,23
2013,22,Hull City,10,23,-5,22,27
2013,22,Aston Villa,11,23,-7,20,27
2013,22,Stoke City,12,22,-13,22,35
2013,22,Swansea,13,21,-4,26,30
2013,22,West Brom,14,21,-5,23,28
2013,22,Norwich,15,20,-18,17,35
2013,22,Fulham,16,19,-24,22,46
2013,22,West Ham,17,18,-9,21,30
2013,22,Cardiff,18,18,-19,15,34
2013,22,Sunderland,19,17,-15,19,34
2013,22,Crystal Palace,20,17,-18,13,31
2013,23,Arsenal,1,51,24,43,19
2013,23,Man City,2,50,38,63,25
2013,23,Chelsea,3,49,23,43,20
2013,23,Liverpool,4,43,25,53,28
2013,23,Spurs,5,43,3,29,26
2013,23,Everton,6,42,15,35,20
2013,23,Man Utd,7,37,9,36,27
2013,23,Newcastle,8,36,4,32,28
2013,23,Southampton,9,31,4,29,25
2013,23,Aston Villa,10,24,-7,22,29
2013,23,Hull City,11,23,-6,22,28
2013,23,Norwich,12,23,-17,18,35
2013,23,West Brom,13,22,-5,24,29
2013,23,Stoke City,14,22,-14,22,36
2013,23,Swansea,15,21,-6,27,33
2013,23,Crystal Palace,16,20,-17,14,31
2013,23,Fulham,17,19,-26,22,48
2013,23,West Ham,18,18,-11,22,33
2013,23,Sunderland,19,18,-15,21,36
2013,23,Cardiff,20,18,-21,17,38
2013,24,Man City,1,53,42,68,26
2013,24,Arsenal,2,52,24,45,21
2013,24,Chelsea,3,50,23,43,20
2013,24,Liverpool,4,46,29,57,28
2013,24,Spurs,5,43,-1,30,31
2013,24,Everton,6,42,11,35,24
2013,24,Man Utd,7,40,11,38,27
2013,24,Newcastle,8,37,4,32,28
2013,24,Southampton,9,32,4,31,27
2013,24,Aston Villa,10,27,-6,26,32
2013,24,Swansea,11,24,-4,29,33
2013,24,Norwich,12,24,-17,18,35
2013,24,Hull City,13,23,-7,22,29
2013,24,Crystal Palace,14,23,-16,15,31
2013,24,West Brom,15,22,-6,27,33
2013,24,Stoke City,16,22,-15,22,37
2013,24,Sunderland,17,21,-14,22,36
2013,24,West Ham,18,19,-11,22,33
2013,24,Fulham,19,19,-28,22,50
2013,24,Cardiff,20,18,-23,17,40
2013,25,Arsenal,1,55,26,47,21
2013,25,Man City,2,53,41,68,27
2013,25,Chelsea,3,53,24,44,20
2013,25,Liverpool,4,47,29,58,29
2013,25,Everton,5,45,12,37,25
2013,25,Spurs,6,44,-1,31,32
2013,25,Man Utd,7,40,10,39,29
2013,25,Newcastle,8,37,1,32,31
2013,25,Southampton,9,35,7,34,27
2013,25,Aston Villa,10,27,-7,27,34
2013,25,Stoke City,11,25,-14,24,38
2013,25,Swansea,12,24,-6,29,35
2013,25,Hull City,13,24,-7,23,30
2013,25,Sunderland,14,24,-11,25,36
2013,25,Norwich,15,24,-18,19,37
2013,25,West Brom,16,23,-6,28,34
2013,25,Crystal Palace,17,23,-18,15,33
2013,25,West Ham,18,22,-9,24,33
2013,25,Cardiff,19,21,-22,19,41
2013,25,Fulham,20,19,-31,22,53
2013,26,Chelsea,1,56,27,47,20
2013,26,Arsenal,2,55,22,48,26
2013,26,Man City,3,54,41,68,27
2013,26,Liverpool,4,50,33,63,30
2013,26,Spurs,5,47,0,32,32
2013,26,Everton,6,45,11,37,26
2013,26,Man Utd,7,41,10,41,31
2013,26,Newcastle,8,37,-2,32,34
2013,26,Southampton,9,36,7,36,29
2013,26,Swansea,10,27,-3,32,35
2013,26,Hull City,11,27,-5,25,30
2013,26,Aston Villa,12,27,-9,27,36
2013,26,Stoke City,13,26,-14,26,40
2013,26,Crystal Palace,14,26,-16,18,34
2013,26,West Ham,15,25,-7,26,33
2013,26,Norwich,16,25,-18,19,37
2013,26,Sunderland,17,24,-13,25,38
2013,26,West Brom,18,23,-8,29,37
2013,26,Cardiff,19,21,-25,19,44
2013,26,Fulham,20,20,-31,24,55
2013,27,Chelsea,1,57,27,48,21
2013,27,Arsenal,2,56,22,48,26
2013,27,Man City,3,55,41,70,29
2013,27,Liverpool,4,53,34,66,32
2013,27,Spurs,5,50,4,36,32
2013,27,Everton,6,45,10,39,29
2013,27,Man Utd,7,42,10,41,31
2013,27,Southampton,8,39,8,37,29
2013,27,Newcastle,9,37,-6,32,38
2013,27,Crystal Palace,10,29,-15,21,36
2013,27,Swansea,11,28,-3,33,36
2013,27,West Ham,12,28,-5,28,33
2013,27,Aston Villa,13,28,-9,27,36
2013,27,Hull City,14,27,-6,25,31
2013,27,Stoke City,15,27,-14,27,41
2013,27,Sunderland,16,25,-13,27,40
2013,27,Norwich,17,25,-20,19,39
2013,27,West Brom,18,24,-8,30,38
2013,27,Cardiff,19,22,-25,19,44
2013,27,Fulham,20,20,-32,26,58
2013,28,Chelsea,1,60,28,49,21
2013,28,Arsenal,2,59,25,52,27
2013,28,Man City,3,58,42,71,29
2013,28,Liverpool,4,56,35,70,35
2013,28,Spurs,5,50,3,36,33
2013,28,Man Utd,6,45,12,43,31
2013,28,Everton,7,45,9,39,30
2013,28,Newcastle,8,40,-5,33,38
2013,28,Southampton,9,39,6,38,32
2013,28,West Ham,10,31,-3,31,34
2013,28,Hull City,11,30,-2,29,31
2013,28,Crystal Palace,12,29,-17,21,38
2013,28,Swansea,13,28,-4,36,40
2013,28,Aston Villa,14,28,-10,27,37
2013,28,Norwich,15,28,-19,20,39
2013,28,Stoke City,16,27,-15,27,42
2013,28,West Brom,17,25,-8,31,39
2013,28,Sunderland,18,25,-16,28,44
2013,28,Cardiff,19,22,-29,19,48
2013,28,Fulham,20,21,-32,27,59
2013,29,Chelsea,1,63,30,52,22
2013,29,Man City,2,61,45,74,29
2013,29,Liverpool,3,59,38,73,35
2013,29,Arsenal,4,59,24,52,28
2013,29,Spurs,5,53,4,37,33
2013,29,Everton,6,48,10,40,30
2013,29,Man Utd,7,45,9,43,34
2013,29,Newcastle,8,43,-2,37,39
2013,29,Southampton,9,39,3,38,35
2013,29,West Ham,10,31,-4,31,35
2013,29,Aston Villa,11,31,-7,31,38
2013,29,Hull City,12,30,-5,30,35
2013,29,Stoke City,13,30,-14,28,42
2013,29,Crystal Palace,14,30,-17,22,39
2013,29,Swansea,15,29,-4,37,41
2013,29,Sunderland,16,28,-14,30,44
2013,29,Norwich,17,28,-22,21,43
2013,29,West Brom,18,25,-10,31,41
2013,29,Cardiff,19,22,-30,19,49
2013,29,Fulham,20,21,-34,28,62
2013,30,Chelsea,1,66,34,56,22
2013,30,Man City,2,64,49,78,29
2013,30,Liverpool,3,62,39,75,36
2013,30,Arsenal,4,60,24,54,30
2013,30,Spurs,5,53,0,37,37
2013,30,Everton,6,51,13,43,30
2013,30,Man Utd,7,48,12,46,34
2013,30,Newcastle,8,43,-5,37,42
2013,30,Southampton,9,42,4,39,35
2013,30,West Ham,10,34,-3,33,36
2013,30,Aston Villa,11,31,-11,31,42
2013,30,Stoke City,12,31,-14,29,43
2013,30,Swansea,13,30,-4,39,43
2013,30,Hull City,14,30,-6,31,37
2013,30,Crystal Palace,15,30,-18,22,40
2013,30,Norwich,16,29,-22,22,44
2013,30,Sunderland,17,28,-15,31,46
2013,30,West Brom,18,25,-13,31,44
2013,30,Cardiff,19,25,-28,22,50
2013,30,Fulham,20,21,-36,29,65
2013,31,Man City,1,67,51,80,29
2013,31,Chelsea,2,66,33,56,23
2013,31,Liverpool,3,65,42,78,36
2013,31,Arsenal,4,63,25,55,30
2013,31,Everton,5,54,14,45,31
2013,31,Spurs,6,53,-1,37,38
2013,31,Man Utd,7,48,9,46,37
2013,31,Southampton,8,45,6,43,37
2013,31,Newcastle,9,43,-6,37,43
2013,31,West Ham,10,34,-5,34,39
2013,31,Aston Villa,11,34,-10,32,42
2013,31,Stoke City,12,34,-12,32,44
2013,31,Crystal Palace,13,31,-18,22,40
2013,31,Swansea,14,30,-5,40,45
2013,31,Hull City,15,30,-8,31,39
2013,31,Sunderland,16,29,-15,31,46
2013,31,Norwich,17,29,-24,24,48
2013,31,West Brom,18,28,-12,33,45
2013,31,Cardiff,19,25,-29,23,52
2013,31,Fulham,20,24,-35,30,65
2013,32,Man City,1,70,56,85,29
2013,32,Chelsea,2,69,39,62,23
2013,32,Liverpool,3,68,45,84,39
2013,32,Arsenal,4,63,19,55,36
2013,32,Everton,5,57,15,48,33
2013,32,Spurs,6,56,0,40,40
2013,32,Man Utd,7,51,11,48,37
2013,32,Newcastle,8,46,-5,38,43
2013,32,Southampton,9,45,5,45,40
2013,32,Stoke City,10,37,-9,36,45
2013,32,West Ham,11,34,-7,34,41
2013,32,Aston Villa,12,34,-13,33,46
2013,32,Hull City,13,33,-6,33,39
2013,32,Norwich,14,32,-22,26,48
2013,32,Crystal Palace,15,31,-19,22,41
2013,32,Swansea,16,30,-6,42,48
2013,32,Sunderland,17,29,-17,31,48
2013,32,West Brom,18,28,-14,33,47
2013,32,Cardiff,19,25,-32,26,58
2013,32,Fulham,20,24,-40,30,70
2013,33,Man City,1,71,56,86,30
2013,33,Liverpool,2,71,49,88,39
2013,33,Chelsea,3,69,38,62,24
2013,33,Arsenal,4,64,19,56,37
2013,33,Everton,5,60,17,51,34
2013,33,Spurs,6,56,-4,40,44
2013,33,Man Utd,7,54,14,52,38
2013,33,Southampton,8,48,9,49,40
2013,33,Newcastle,9,46,-9,38,47
2013,33,Stoke City,10,40,-8,37,45
2013,33,West Ham,11,37,-6,36,42
2013,33,Aston Villa,12,34,-16,34,50
2013,33,Crystal Palace,13,34,-18,23,41
2013,33,Swansea,14,33,-3,45,48
2013,33,Hull City,15,33,-7,33,40
2013,33,Norwich,16,32,-25,26,51
2013,33,West Brom,17,29,-14,36,50
2013,33,Sunderland,18,29,-18,32,50
2013,33,Cardiff,19,26,-32,29,61
2013,33,Fulham,20,24,-42,31,73
2013,34,Man City,1,74,59,90,31
2013,34,Liverpool,2,74,50,90,40
2013,34,Chelsea,3,72,41,65,24
2013,34,Arsenal,4,64,16,56,40
2013,34,Everton,5,63,20,54,34
2013,34,Spurs,6,59,0,45,45
2013,34,Man Utd,7,57,18,56,38
2013,34,Southampton,8,48,6,50,44
2013,34,Newcastle,9,46,-13,38,51
2013,34,Stoke City,10,40,-11,37,48
2013,34,West Ham,11,37,-7,37,44
2013,34,Crystal Palace,12,37,-15,26,41
2013,34,Hull City,13,36,-6,34,40
2013,34,Aston Villa,14,34,-17,35,52
2013,34,Swansea,15,33,-4,45,49
2013,34,West Brom,16,32,-13,37,50
2013,34,Norwich,17,32,-26,26,52
2013,34,Sunderland,18,29,-22,33,55
2013,34,Fulham,19,27,-41,33,74
2013,34,Cardiff,20,26,-35,29,64
2013,35,Liverpool,1,77,51,93,42
2013,35,Chelsea,2,75,42,66,24
2013,35,Man City,3,74,58,92,34
2013,35,Arsenal,4,67,18,59,41
2013,35,Everton,5,66,21,55,34
2013,35,Man Utd,6,60,20,59,39
2013,35,Spurs,7,60,0,48,48
2013,35,Southampton,8,48,5,50,45
2013,35,Newcastle,9,46,-14,38,52
2013,35,Stoke City,10,43,-10,38,48
2013,35,Crystal Palace,11,40,-14,27,41
2013,35,West Ham,12,37,-9,38,47
2013,35,Hull City,13,36,-8,35,43
2013,35,Aston Villa,14,34,-18,35,53
2013,35,Swansea,15,33,-5,45,50
2013,35,West Brom,16,33,-13,40,53
2013,35,Norwich,17,32,-27,26,53
2013,35,Fulham,18,30,-40,34,74
2013,35,Sunderland,19,29,-23,33,56
2013,35,Cardiff,20,29,-34,30,64
2013,36,Liverpool,1,80,52,96,44
2013,36,Man City,2,77,60,95,35
2013,36,Chelsea,3,75,41,67,26
2013,36,Arsenal,4,70,21,62,41
2013,36,Everton,5,69,23,57,34
2013,36,Spurs,6,63,2,51,49
2013,36,Man Utd,7,60,18,59,41
2013,36,Southampton,8,49,5,50,45
2013,36,Newcastle,9,46,-15,39,54
2013,36,Stoke City,10,44,-10,39,49
2013,36,Crystal Palace,11,43,-13,28,41
2013,36,West Ham,12,37,-10,38,48
2013,36,Swansea,13,36,-4,47,51
2013,36,Hull City,14,36,-11,35,46
2013,36,Aston Villa,15,35,-18,35,53
2013,36,West Brom,16,33,-15,41,56
2013,36,Sunderland,17,32,-22,35,57
2013,36,Norwich,18,32,-28,28,56
2013,36,Cardiff,19,30,-34,31,65
2013,36,Fulham,20,30,-42,35,77
2013,37,Man City,1,80,62,97,35
2013,37,Liverpool,2,80,50,96,46
2013,37,Chelsea,3,78,43,69,26
2013,37,Arsenal,4,73,24,65,41
2013,37,Everton,5,69,21,57,36
2013,37,Spurs,6,66,3,52,49
2013,37,Man Utd,7,63,22,63,41
2013,37,Southampton,8,52,7,52,45
2013,37,Newcastle,9,46,-18,39,57
2013,37,Stoke City,10,44,-11,39,50
2013,37,Crystal Palace,11,43,-15,28,43
2013,37,Swansea,12,39,-1,51,52
2013,37,West Ham,13,37,-11,38,49
2013,37,Hull City,14,37,-11,37,48
2013,37,West Brom,15,36,-14,42,56
2013,37,Sunderland,16,35,-18,39,57
2013,37,Aston Villa,17,35,-21,36,57
2013,37,Norwich,18,32,-32,28,60
2013,37,Fulham,19,31,-42,37,79
2013,37,Cardiff,20,30,-38,31,69
2013,38,Man City,1,83,63,100,37
2013,38,Liverpool,2,81,50,99,49
2013,38,Chelsea,3,79,43,69,26
2013,38,Arsenal,4,76,25,66,41
2013,38,Everton,5,69,20,59,39
2013,38,Spurs,6,66,1,52,51
2013,38,Man Utd,7,63,21,63,42
2013,38,Southampton,8,55,8,53,45
2013,38,Newcastle,9,49,-15,42,57
2013,38,Stoke City,10,47,-8,43,51
2013,38,Crystal Palace,11,44,-15,31,46
2013,38,West Ham,12,40,-9,40,49
2013,38,Swansea,13,39,-2,51,53
2013,38,Sunderland,14,38,-17,40,57
2013,38,Aston Villa,15,38,-19,39,58
2013,38,Hull City,16,37,-13,38,51
2013,38,West Brom,17,36,-15,42,57
2013,38,Norwich,18,33,-32,28,60
2013,38,Fulham,19,31,-45,38,83
2013,38,Cardiff,20,30,-41,31,72
2013,39,Man City,1,86,65,102,37
2013,39,Liverpool,2,84,51,101,50
2013,39,Chelsea,3,82,44,71,27
2013,39,Arsenal,4,79,27,68,41
2013,39,Everton,5,72,22,61,39
2013,39,Spurs,6,69,4,55,51
2013,39,Man Utd,7,64,21,64,43
2013,39,Southampton,8,56,8,54,46
2013,39,Stoke City,9,50,-7,45,52
2013,39,Newcastle,10,49,-16,43,59
2013,39,Crystal Palace,11,45,-15,33,48
2013,39,Swansea,12,42,0,54,54
2013,39,West Ham,13,40,-11,40,51
2013,39,Sunderland,14,38,-19,41,60
2013,39,Aston Villa,15,38,-22,39,61
2013,39,Hull City,16,37,-15,38,53
2013,39,West Brom,17,36,-16,43,59
2013,39,Norwich,18,33,-34,28,62
2013,39,Fulham,19,32,-45,40,85
2013,39,Cardiff,20,30,-42,32,74
2014,2,Chelsea,1,3,2,3,1
2014,2,Man City,2,3,2,2,0
2014,2,Arsenal,3,3,1,2,1
2014,2,Liverpool,4,3,1,2,1
2014,2,Swansea,5,3,1,2,1
2014,2,Aston Villa,6,3,1,1,0
2014,2,Hull City,7,3,1,1,0
2014,2,Spurs,8,3,1,1,0
2014,2,Everton,9,1,0,2,2
2014,2,Leicester,10,1,0,2,2
2014,2,Sunderland,11,1,0,2,2
2014,2,West Brom,12,1,0,2,2
2014,2,Crystal Palace,13,0,-1,1,2
2014,2,Man Utd,14,0,-1,1,2
2014,2,Southampton,15,0,-1,1,2
2014,2,QPR,16,0,-1,0,1
2014,2,Stoke City,17,0,-1,0,1
2014,2,West Ham,18,0,-1,0,1
2014,2,Burnley,19,0,-2,1,3
2014,2,Newcastle,20,0,-2,0,2
2014,3,Spurs,1,6,5,5,0
2014,3,Chelsea,2,6,4,5,1
2014,3,Man City,3,6,4,5,1
2014,3,Swansea,4,6,2,3,1
2014,3,Arsenal,5,4,1,4,3
2014,3,Hull City,6,4,1,2,1
2014,3,Aston Villa,7,4,1,1,0
2014,3,West Ham,8,3,1,3,2
2014,3,Liverpool,9,3,-1,3,4
2014,3,Everton,10,2,0,4,4
2014,3,Sunderland,11,2,0,3,3
2014,3,West Brom,12,2,0,2,2
2014,3,Man Utd,13,1,-1,2,3
2014,3,Southampton,14,1,-1,1,2
2014,3,Stoke City,15,1,-1,1,2
2014,3,Leicester,16,1,-2,2,4
2014,3,Newcastle,17,1,-2,0,2
2014,3,Crystal Palace,18,0,-3,2,5
2014,3,Burnley,19,0,-3,1,4
2014,3,QPR,20,0,-5,0,5
2014,4,Chelsea,1,9,7,11,4
2014,4,Swansea,2,9,5,6,1
2014,4,Aston Villa,3,7,2,3,1
2014,4,Man City,4,6,3,5,2
2014,4,Liverpool,5,6,2,6,4
2014,4,Spurs,6,6,2,5,3
2014,4,Arsenal,7,5,1,5,4
2014,4,Southampton,8,4,1,4,3
2014,4,Hull City,9,4,0,3,3
2014,4,Stoke City,10,4,0,2,2
2014,4,West Ham,11,3,-1,4,5
2014,4,QPR,12,3,-4,1,5
2014,4,Sunderland,13,2,-1,3,4
2014,4,Man Utd,14,2,-1,2,3
2014,4,Leicester,15,2,-2,3,5
2014,4,Newcastle,16,2,-2,3,5
2014,4,Everton,17,2,-3,7,10
2014,4,West Brom,18,2,-3,2,5
2014,4,Crystal Palace,19,1,-3,5,8
2014,4,Burnley,20,1,-3,1,4
2014,5,Chelsea,1,12,9,15,6
2014,5,Aston Villa,2,10,3,4,1
2014,5,Swansea,3,9,3,8,5
2014,5,Southampton,4,7,5,8,3
2014,5,Man City,5,7,3,7,4
2014,5,Spurs,6,7,2,7,5
2014,5,Arsenal,7,6,1,7,6
2014,5,Liverpool,8,6,1,6,5
2014,5,Man Utd,9,5,3,6,3
2014,5,Hull City,10,5,0,5,5
2014,5,Everton,11,5,-1,9,10
2014,5,Leicester,12,5,-1,4,5
2014,5,West Ham,13,4,-1,6,7
2014,5,Stoke City,14,4,-1,2,3
2014,5,Sunderland,15,3,-1,5,6
2014,5,QPR,16,3,-8,1,9
2014,5,Crystal Palace,17,2,-3,5,8
2014,5,Burnley,18,2,-3,1,4
2014,5,West Brom,19,2,-5,2,7
2014,5,Newcastle,20,2,-6,3,9
2014,6,Chelsea,1,13,9,16,7
2014,6,Southampton,2,10,6,9,3
2014,6,Aston Villa,3,10,0,4,4
2014,6,Arsenal,4,9,4,10,6
2014,6,Swansea,5,9,2,8,6
2014,6,Man City,6,8,3,8,5
2014,6,Leicester,7,8,1,9,8
2014,6,West Ham,8,7,1,9,8
2014,6,Spurs,9,7,1,7,6
2014,6,Hull City,10,6,0,7,7
2014,6,Liverpool,11,6,-1,7,8
2014,6,Man Utd,12,5,1,9,8
2014,6,Stoke City,13,5,-1,4,5
2014,6,Everton,14,5,-2,11,13
2014,6,Crystal Palace,15,5,-2,8,10
2014,6,West Brom,16,5,-4,3,7
2014,6,Sunderland,17,4,-1,5,6
2014,6,QPR,18,4,-8,3,11
2014,6,Burnley,19,3,-3,1,4
2014,6,Newcastle,20,3,-6,5,11
2014,7,Chelsea,1,16,12,19,7
2014,7,Southampton,2,13,7,11,4
2014,7,Man City,3,11,5,12,7
2014,7,Arsenal,4,10,4,11,7
2014,7,Swansea,5,10,2,8,6
2014,7,Aston Villa,6,10,-3,4,7
2014,7,Man Utd,7,8,2,11,9
2014,7,Spurs,8,8,1,8,7
2014,7,Crystal Palace,9,8,0,10,10
2014,7,West Brom,10,8,0,7,7
2014,7,Stoke City,11,8,0,5,5
2014,7,Leicester,12,8,-1,9,10
2014,7,West Ham,13,7,0,10,10
2014,7,Liverpool,14,7,-1,8,9
2014,7,Everton,15,6,-2,12,14
2014,7,Hull City,16,6,-2,9,11
2014,7,Sunderland,17,5,-1,5,6
2014,7,QPR,18,4,-9,4,13
2014,7,Newcastle,19,3,-7,5,12
2014,7,Burnley,20,3,-7,1,8
2014,8,Chelsea,1,19,14,21,7
2014,8,Man City,2,14,7,14,7
2014,8,Southampton,3,13,6,11,5
2014,8,Man Utd,4,11,3,13,10
2014,8,Swansea,5,11,2,10,8
2014,8,Spurs,6,11,2,9,7
2014,8,West Ham,7,10,2,12,10
2014,8,Arsenal,8,10,2,11,9
2014,8,Liverpool,9,10,0,10,10
2014,8,Aston Villa,10,10,-5,4,9
2014,8,Hull City,11,9,0,11,11
2014,8,Leicester,12,9,-1,11,12
2014,8,Sunderland,13,8,1,8,7
2014,8,West Brom,14,8,-1,8,9
2014,8,Crystal Palace,15,8,-2,10,12
2014,8,Stoke City,16,8,-2,6,8
2014,8,Everton,17,6,-3,13,16
2014,8,Newcastle,18,4,-7,7,14
2014,8,Burnley,19,4,-7,3,10
2014,8,QPR,20,4,-11,4,15
2014,9,Chelsea,1,22,15,23,8
2014,9,Man City,2,17,10,18,8
2014,9,Southampton,3,16,14,19,5
2014,9,West Ham,4,13,4,15,11
2014,9,Liverpool,5,13,1,13,12
2014,9,Man Utd,6,12,3,15,12
2014,9,Arsenal,7,11,2,13,11
2014,9,Swansea,8,11,1,11,10
2014,9,Spurs,9,11,-1,10,11
2014,9,Stoke City,10,11,-1,8,9
2014,9,Hull City,11,10,0,13,13
2014,9,Aston Villa,12,10,-8,4,12
2014,9,Everton,13,9,0,16,16
2014,9,West Brom,14,9,-1,10,11
2014,9,Leicester,15,9,-2,11,13
2014,9,Crystal Palace,16,8,-3,11,14
2014,9,Sunderland,17,8,-7,8,15
2014,9,Newcastle,18,7,-6,8,14
2014,9,Burnley,19,4,-9,4,13
2014,9,QPR,20,4,-12,6,18
2014,10,Chelsea,1,23,15,24,9
2014,10,Southampton,2,19,15,20,5
2014,10,Man City,3,17,9,19,10
2014,10,West Ham,4,16,5,17,12
2014,10,Arsenal,5,14,4,15,11
2014,10,Swansea,6,14,3,13,10
2014,10,Liverpool,7,14,1,13,12
2014,10,Man Utd,8,13,3,16,13
2014,10,Everton,9,12,2,19,17
2014,10,Hull City,10,11,0,13,13
2014,10,Spurs,11,11,-2,11,13
2014,10,Stoke City,12,11,-2,8,10
2014,10,West Brom,13,10,-1,12,13
2014,10,Newcastle,14,10,-5,10,15
2014,10,Aston Villa,15,10,-10,4,14
2014,10,Crystal Palace,16,9,-3,13,16
2014,10,Leicester,17,9,-4,11,15
2014,10,Sunderland,18,8,-9,8,17
2014,10,QPR,19,7,-10,8,18
2014,10,Burnley,20,4,-11,5,16
2014,11,Chelsea,1,26,16,26,10
2014,11,Southampton,2,22,16,21,5
2014,11,Man City,3,20,10,20,10
2014,11,Arsenal,4,17,7,18,11
2014,11,West Ham,5,17,5,19,14
2014,11,Swansea,6,15,3,13,10
2014,11,Liverpool,7,14,0,13,13
2014,11,Spurs,8,14,-1,13,14
2014,11,Everton,9,13,2,19,17
2014,11,Man Utd,10,13,2,16,14
2014,11,West Brom,11,13,0,13,13
2014,11,Newcastle,12,13,-4,11,15
2014,11,Stoke City,13,12,-2,10,12
2014,11,Hull City,14,11,-1,13,14
2014,11,Sunderland,15,11,-7,11,18
2014,11,Aston Villa,16,10,-11,5,16
2014,11,Crystal Palace,17,9,-5,14,19
2014,11,Leicester,18,9,-5,11,16
2014,11,QPR,19,7,-11,9,20
2014,11,Burnley,20,4,-14,5,19
2014,12,Chelsea,1,29,17,28,11
2014,12,Southampton,2,25,18,23,5
2014,12,Man City,3,21,10,22,12
2014,12,West Ham,4,18,5,19,14
2014,12,Swansea,5,18,4,15,11
2014,12,Arsenal,6,17,6,19,13
2014,12,Man Utd,7,16,3,17,14
2014,12,Newcastle,8,16,-2,13,15
2014,12,Stoke City,9,15,-1,12,13
2014,12,Everton,10,14,2,20,18
2014,12,Liverpool,11,14,-1,14,15
2014,12,Spurs,12,14,-2,14,16
2014,12,West Brom,13,13,-2,13,15
2014,12,Sunderland,14,12,-7,12,19
2014,12,Hull City,15,11,-2,13,15
2014,12,Aston Villa,16,11,-11,5,16
2014,12,Crystal Palace,17,9,-6,14,20
2014,12,Leicester,18,9,-7,11,18
2014,12,QPR,19,8,-11,11,22
2014,12,Burnley,20,7,-13,6,19
2014,13,Chelsea,1,32,19,30,11
2014,13,Southampton,2,26,18,24,6
2014,13,Man City,3,24,11,24,13
2014,13,Man Utd,4,19,4,19,15
2014,13,Newcastle,5,19,-1,14,15
2014,13,West Ham,6,18,4,20,16
2014,13,Swansea,7,18,3,16,13
2014,13,Arsenal,8,17,5,20,15
2014,13,Everton,9,17,3,22,19
2014,13,Spurs,10,17,-1,16,17
2014,13,Stoke City,11,15,-2,13,15
2014,13,Liverpool,12,14,-3,15,18
2014,13,West Brom,13,13,-4,13,17
2014,13,Sunderland,14,13,-7,12,19
2014,13,Crystal Palace,15,12,-4,17,21
2014,13,Aston Villa,16,12,-11,6,17
2014,13,Hull City,17,11,-3,14,17
2014,13,Leicester,18,10,-7,11,18
2014,13,Burnley,19,10,-12,8,20
2014,13,QPR,20,8,-12,11,23
2014,14,Chelsea,1,33,19,30,11
2014,14,Man City,2,27,14,27,13
2014,14,Southampton,3,26,15,24,9
2014,14,Man Utd,4,22,7,22,15
2014,14,West Ham,5,21,5,21,16
2014,14,Arsenal,6,20,6,21,15
2014,14,Spurs,7,20,0,18,18
2014,14,Swansea,8,19,3,17,14
2014,14,Newcastle,9,19,-2,14,16
2014,14,Everton,10,17,2,23,21
2014,14,Liverpool,11,17,-2,16,18
2014,14,Stoke City,12,15,-3,13,16
2014,14,Sunderland,13,14,-7,12,19
2014,14,Crystal Palace,14,13,-4,18,22
2014,14,West Brom,15,13,-5,13,18
2014,14,Aston Villa,16,13,-11,7,18
2014,14,Hull City,17,11,-6,14,20
2014,14,QPR,18,11,-11,14,25
2014,14,Burnley,19,11,-12,9,21
2014,14,Leicester,20,10,-8,13,21
2014,15,Chelsea,1,36,22,33,11
2014,15,Man City,2,30,17,31,14
2014,15,Southampton,3,26,14,24,10
2014,15,Man Utd,4,25,8,24,16
2014,15,West Ham,5,24,6,23,17
2014,15,Arsenal,6,23,7,22,15
2014,15,Swansea,7,22,5,19,14
2014,15,Liverpool,8,20,0,19,19
2014,15,Newcastle,9,20,-2,15,17
2014,15,Spurs,10,20,-3,18,21
2014,15,Everton,11,18,2,24,22
2014,15,Aston Villa,12,16,-10,8,18
2014,15,Stoke City,13,15,-4,14,18
2014,15,Sunderland,14,14,-10,13,23
2014,15,Crystal Palace,15,13,-5,18,23
2014,15,West Brom,16,13,-6,14,20
2014,15,Hull City,17,12,-6,15,21
2014,15,Burnley,18,12,-12,10,22
2014,15,QPR,19,11,-13,14,27
2014,15,Leicester,20,10,-10,14,24
2014,16,Chelsea,1,36,21,34,13
2014,16,Man City,2,33,18,32,14
2014,16,Man Utd,3,28,9,26,17
2014,16,West Ham,4,27,8,26,18
2014,16,Southampton,5,26,13,25,12
2014,16,Arsenal,6,23,6,24,18
2014,16,Newcastle,7,23,-1,17,18
2014,16,Swansea,8,22,3,20,17
2014,16,Liverpool,9,21,0,19,19
2014,16,Spurs,10,21,-3,18,21
2014,16,Aston Villa,11,19,-9,10,19
2014,16,Everton,12,18,1,24,23
2014,16,Stoke City,13,18,-3,17,20
2014,16,Sunderland,14,15,-10,13,23
2014,16,Crystal Palace,15,14,-5,18,23
2014,16,West Brom,16,14,-6,14,20
2014,16,QPR,17,14,-11,16,27
2014,16,Hull City,18,13,-6,15,21
2014,16,Burnley,19,12,-14,10,24
2014,16,Leicester,20,10,-11,15,26
2014,17,Chelsea,1,39,23,36,13
2014,17,Man City,2,36,19,33,14
2014,17,Man Utd,3,31,12,29,17
2014,17,West Ham,4,28,8,27,19
2014,17,Southampton,5,26,12,25,13
2014,17,Arsenal,6,26,9,28,19
2014,17,Spurs,7,24,-2,20,22
2014,17,Newcastle,8,23,-4,18,22
2014,17,Swansea,9,22,2,21,19
2014,17,Everton,10,21,3,27,24
2014,17,Liverpool,11,21,-3,19,22
2014,17,Stoke City,12,19,-3,18,21
2014,17,Aston Villa,13,19,-10,10,20
2014,17,West Brom,14,17,-5,15,20
2014,17,Sunderland,15,16,-10,14,24
2014,17,Crystal Palace,16,15,-5,19,24
2014,17,Burnley,17,15,-13,11,24
2014,17,QPR,18,14,-13,17,30
2014,17,Hull City,19,13,-8,15,23
2014,17,Leicester,20,10,-12,15,27
2014,18,Chelsea,1,42,25,38,13
2014,18,Man City,2,39,22,36,14
2014,18,Man Utd,3,32,12,30,18
2014,18,West Ham,4,31,10,29,19
2014,18,Southampton,5,29,15,28,13
2014,18,Arsenal,6,27,9,30,21
2014,18,Spurs,7,27,-1,22,23
2014,18,Swansea,8,25,3,22,19
2014,18,Newcastle,9,23,-5,18,23
2014,18,Liverpool,10,22,-3,21,24
2014,18,Everton,11,21,0,27,27
2014,18,Aston Villa,12,20,-10,11,21
2014,18,Stoke City,13,19,-5,18,23
2014,18,Sunderland,14,19,-9,15,24
2014,18,West Brom,15,17,-6,17,23
2014,18,QPR,16,17,-12,20,32
2014,18,Crystal Palace,17,15,-8,19,27
2014,18,Burnley,18,15,-14,12,26
2014,18,Hull City,19,13,-9,15,24
2014,18,Leicester,20,10,-14,15,29
2014,19,Chelsea,1,45,27,40,13
2014,19,Man City,2,42,24,39,15
2014,19,Man Utd,3,35,14,33,19
2014,19,Southampton,4,32,17,31,14
2014,19,West Ham,5,31,8,29,21
2014,19,Arsenal,6,30,10,32,22
2014,19,Spurs,7,30,0,24,24
2014,19,Swansea,8,28,4,23,19
2014,19,Liverpool,9,25,-2,22,24
2014,19,Newcastle,10,23,-7,19,26
2014,19,Stoke City,11,22,-4,19,23
2014,19,Everton,12,21,-1,27,28
2014,19,Aston Villa,13,20,-11,11,22
2014,19,Sunderland,14,19,-11,16,27
2014,19,West Brom,15,17,-8,18,26
2014,19,QPR,16,17,-13,21,34
2014,19,Hull City,17,16,-7,18,25
2014,19,Crystal Palace,18,15,-10,20,30
2014,19,Burnley,19,15,-15,12,27
2014,19,Leicester,20,10,-15,16,31
2014,20,Chelsea,1,46,27,41,14
2014,20,Man City,2,43,24,41,17
2014,20,Man Utd,3,36,14,33,19
2014,20,Southampton,4,33,17,32,15
2014,20,Arsenal,5,33,11,34,23
2014,20,West Ham,6,31,7,30,23
2014,20,Spurs,7,31,0,24,24
2014,20,Liverpool,8,28,1,26,25
2014,20,Swansea,9,28,1,24,23
2014,20,Newcastle,10,26,-6,22,28
2014,20,Stoke City,11,25,-2,21,23
2014,20,Everton,12,21,-2,29,31
2014,20,Aston Villa,13,21,-11,11,22
2014,20,Sunderland,14,20,-11,16,27
2014,20,QPR,15,18,-13,21,34
2014,20,West Brom,16,17,-10,18,28
2014,20,Hull City,17,16,-8,18,26
2014,20,Crystal Palace,18,16,-10,20,30
2014,20,Burnley,19,16,-15,14,29
2014,20,Leicester,20,13,-14,17,31
2014,21,Chelsea,1,46,25,44,19
2014,21,Man City,2,46,25,44,19
2014,21,Man Utd,3,37,14,34,20
2014,21,Southampton,4,36,19,34,15
2014,21,Spurs,5,34,2,29,27
2014,21,Arsenal,6,33,9,34,25
2014,21,West Ham,7,32,7,31,24
2014,21,Liverpool,8,29,1,28,27
2014,21,Swansea,9,29,1,25,24
2014,21,Newcastle,10,27,-6,25,31
2014,21,Stoke City,11,26,-2,22,24
2014,21,Aston Villa,12,22,-11,11,22
2014,21,Everton,13,21,-4,29,33
2014,21,Sunderland,14,20,-12,18,30
2014,21,Hull City,15,19,-6,20,26
2014,21,QPR,16,19,-13,22,35
2014,21,West Brom,17,18,-10,19,29
2014,21,Crystal Palace,18,17,-10,20,30
2014,21,Burnley,19,17,-15,17,32
2014,21,Leicester,20,14,-14,19,33
2014,22,Chelsea,1,49,27,46,19
2014,22,Man City,2,47,25,45,20
2014,22,Southampton,3,39,20,35,15
2014,22,Man Utd,4,37,13,34,21
2014,22,Arsenal,5,36,12,37,25
2014,22,Spurs,6,34,1,30,29
2014,22,West Ham,7,33,7,32,25
2014,22,Liverpool,8,32,2,29,27
2014,22,Swansea,9,30,1,26,25
2014,22,Newcastle,10,27,-8,25,33
2014,22,Stoke City,11,26,-5,22,27
2014,22,Everton,12,22,-4,30,34
2014,22,Aston Villa,13,22,-12,11,23
2014,22,West Brom,14,21,-9,20,29
2014,22,Crystal Palace,15,20,-9,22,31
2014,22,Sunderland,16,20,-13,18,31
2014,22,Burnley,17,20,-14,19,33
2014,22,Hull City,18,19,-7,20,27
2014,22,QPR,19,19,-14,23,37
2014,22,Leicester,20,17,-13,20,33
2014,23,Chelsea,1,52,32,51,19
2014,23,Man City,2,47,23,45,22
2014,23,Southampton,3,42,21,37,16
2014,23,Man Utd,4,40,15,36,21
2014,23,Arsenal,5,39,14,39,25
2014,23,Spurs,6,37,2,32,30
2014,23,West Ham,7,36,10,35,25
2014,23,Liverpool,8,35,4,31,27
2014,23,Swansea,9,30,-4,26,30
2014,23,Stoke City,10,29,-4,23,27
2014,23,Newcastle,11,27,-9,26,35
2014,23,Everton,12,23,-4,30,34
2014,23,Crystal Palace,13,23,-8,25,33
2014,23,West Brom,14,22,-9,20,29
2014,23,Aston Villa,15,22,-14,11,25
2014,23,Sunderland,16,20,-14,19,33
2014,23,Burnley,17,20,-15,21,36
2014,23,Hull City,18,19,-10,20,30
2014,23,QPR,19,19,-16,23,39
2014,23,Leicester,20,17,-14,20,34
2014,24,Chelsea,1,53,32,52,20
2014,24,Man City,2,48,23,46,23
2014,24,Man Utd,3,43,17,39,22
2014,24,Southampton,4,42,20,37,17
2014,24,Arsenal,5,42,19,44,25
2014,24,Spurs,6,40,5,35,30
2014,24,Liverpool,7,38,6,33,27
2014,24,West Ham,8,36,8,35,27
2014,24,Swansea,9,33,-3,27,30
2014,24,Stoke City,10,32,-2,26,28
2014,24,Newcastle,11,30,-6,29,35
2014,24,Everton,12,26,-3,31,34
2014,24,Crystal Palace,13,23,-9,25,34
2014,24,Sunderland,14,23,-12,21,33
2014,24,West Brom,15,22,-12,20,32
2014,24,Aston Villa,16,22,-19,11,30
2014,24,Burnley,17,20,-17,21,38
2014,24,Hull City,18,19,-13,20,33
2014,24,QPR,19,19,-18,24,42
2014,24,Leicester,20,17,-16,21,37
2014,25,Chelsea,1,56,33,54,21
2014,25,Man City,2,49,23,47,24
2014,25,Southampton,3,45,21,38,17
2014,25,Man Utd,4,44,17,40,23
2014,25,Spurs,5,43,6,37,31
2014,25,Arsenal,6,42,18,45,27
2014,25,Liverpool,7,39,6,33,27
2014,25,West Ham,8,37,8,36,28
2014,25,Swansea,9,34,-3,28,31
2014,25,Stoke City,10,33,-2,27,29
2014,25,Newcastle,11,31,-6,30,36
2014,25,Everton,12,27,-3,31,34
2014,25,Crystal Palace,13,26,-8,26,34
2014,25,Sunderland,14,24,-12,22,34
2014,25,West Brom,15,23,-12,22,34
2014,25,Aston Villa,16,22,-20,12,32
2014,25,Burnley,17,21,-17,23,40
2014,25,Hull City,18,20,-13,21,34
2014,25,QPR,19,19,-19,24,43
2014,25,Leicester,20,17,-17,21,38
2014,26,Chelsea,1,59,34,55,21
2014,26,Man City,2,52,26,51,25
2014,26,Man Utd,3,47,19,43,24
2014,26,Southampton,4,46,21,38,17
2014,26,Arsenal,5,45,19,47,28
2014,26,Spurs,6,43,5,39,34
2014,26,Liverpool,7,42,7,36,29
2014,26,West Ham,8,38,8,36,28
2014,26,Swansea,9,34,-5,28,33
2014,26,Stoke City,10,33,-5,28,33
2014,26,Newcastle,11,32,-6,31,37
2014,26,Everton,12,27,-4,31,35
2014,26,Crystal Palace,13,27,-8,27,35
2014,26,West Brom,14,26,-10,24,34
2014,26,Sunderland,15,24,-14,22,36
2014,26,Hull City,16,23,-11,23,34
2014,26,QPR,17,22,-17,26,43
2014,26,Aston Villa,18,22,-22,12,34
2014,26,Burnley,19,21,-19,24,43
2014,26,Leicester,20,17,-18,22,40
2014,27,Chelsea,1,60,34,56,22
2014,27,Man City,2,55,31,56,25
2014,27,Arsenal,3,48,20,49,29
2014,27,Man Utd,4,47,18,44,26
2014,27,Southampton,5,46,19,38,19
2014,27,Liverpool,6,45,9,38,29
2014,27,Spurs,7,44,5,41,36
2014,27,West Ham,8,39,8,38,30
2014,27,Swansea,9,37,-4,30,34
2014,27,Stoke City,10,36,-4,30,34
2014,27,Newcastle,11,32,-11,31,42
2014,27,Everton,12,28,-4,33,37
2014,27,Crystal Palace,13,27,-9,28,37
2014,27,West Brom,14,27,-10,24,34
2014,27,Hull City,15,26,-10,25,35
2014,27,Sunderland,16,25,-14,22,36
2014,27,QPR,17,22,-18,27,45
2014,27,Burnley,18,22,-19,25,44
2014,27,Aston Villa,19,22,-23,13,36
2014,27,Leicester,20,18,-18,24,42
2014,28,Chelsea,1,63,36,59,23
2014,28,Man City,2,55,30,57,27
2014,28,Arsenal,3,51,22,51,29
2014,28,Man Utd,4,50,20,46,26
2014,28,Liverpool,5,48,10,40,30
2014,28,Spurs,6,47,6,43,37
2014,28,Southampton,7,46,18,38,20
2014,28,Swansea,8,40,-3,31,34
2014,28,West Ham,9,39,6,39,33
2014,28,Stoke City,10,39,-3,31,34
2014,28,Newcastle,11,35,-10,32,42
2014,28,Crystal Palace,12,30,-7,31,38
2014,28,West Brom,13,30,-9,25,34
2014,28,Everton,14,28,-6,33,39
2014,28,Hull City,15,26,-11,25,36
2014,28,Sunderland,16,25,-16,22,38
2014,28,QPR,17,22,-19,28,47
2014,28,Burnley,18,22,-20,25,45
2014,28,Aston Villa,19,22,-24,13,37
2014,28,Leicester,20,18,-20,25,45
2014,29,Chelsea,1,66,37,60,23
2014,29,Man City,2,58,32,59,27
2014,29,Arsenal,3,54,23,53,30
2014,29,Man Utd,4,53,21,47,26
2014,29,Liverpool,5,51,12,42,30
2014,29,Spurs,6,50,7,46,39
2014,29,Southampton,7,49,19,39,20
2014,29,Stoke City,8,42,-1,33,34
2014,29,Swansea,9,40,-4,33,37
2014,29,West Ham,10,39,5,39,34
2014,29,Newcastle,11,35,-11,32,43
2014,29,Crystal Palace,12,30,-8,31,39
2014,29,West Brom,13,30,-10,26,36
2014,29,Everton,14,28,-8,33,41
2014,29,Hull City,15,27,-11,26,37
2014,29,Sunderland,16,26,-16,23,39
2014,29,Aston Villa,17,25,-23,15,38
2014,29,QPR,18,22,-20,29,49
2014,29,Burnley,19,22,-22,25,47
2014,29,Leicester,20,18,-22,25,47
2014,30,Chelsea,1,67,37,61,24
2014,30,Man City,2,58,31,59,28
2014,30,Arsenal,3,57,26,56,30
2014,30,Man Utd,4,56,24,50,26
2014,30,Liverpool,5,54,13,43,30
2014,30,Southampton,6,50,19,40,21
2014,30,Spurs,7,50,4,46,42
2014,30,Stoke City,8,42,-2,33,35
2014,30,Swansea,9,40,-5,33,38
2014,30,West Ham,10,39,2,39,37
2014,30,Newcastle,11,35,-14,32,46
2014,30,Crystal Palace,12,33,-6,34,40
2014,30,West Brom,13,33,-9,27,36
2014,30,Everton,14,31,-5,36,41
2014,30,Hull City,15,28,-11,26,37
2014,30,Aston Villa,16,28,-19,19,38
2014,30,Sunderland,17,26,-20,23,43
2014,30,Burnley,18,25,-21,26,47
2014,30,QPR,19,22,-22,30,52
2014,30,Leicester,20,19,-22,25,47
2014,31,Chelsea,1,70,38,64,26
2014,31,Man City,2,61,34,62,28
2014,31,Arsenal,3,60,27,58,31
2014,31,Man Utd,4,59,25,52,27
2014,31,Liverpool,5,54,12,44,32
2014,31,Southampton,6,53,21,42,21
2014,31,Spurs,7,53,5,50,45
2014,31,Swansea,8,43,-4,34,38
2014,31,West Ham,9,42,3,40,37
2014,31,Stoke City,10,42,-3,34,37
2014,31,Crystal Palace,11,36,-5,36,41
2014,31,Newcastle,12,35,-15,33,48
2014,31,Everton,13,34,-4,38,42
2014,31,West Brom,14,33,-12,27,39
2014,31,Hull City,15,28,-12,28,40
2014,31,Aston Villa,16,28,-20,19,39
2014,31,Sunderland,17,26,-21,23,44
2014,31,Burnley,18,25,-23,26,49
2014,31,QPR,19,22,-23,31,54
2014,31,Leicester,20,19,-23,28,51
2014,32,Chelsea,1,73,39,66,27
2014,32,Arsenal,2,63,30,62,32
2014,32,Man Utd,3,62,27,55,28
2014,32,Man City,4,61,33,63,30
2014,32,Liverpool,5,54,9,45,36
2014,32,Spurs,6,54,5,50,45
2014,32,Southampton,7,53,20,42,22
2014,32,Swansea,8,46,-2,37,39
2014,32,West Ham,9,42,2,41,39
2014,32,Stoke City,10,42,-4,35,39
2014,32,Crystal Palace,11,39,-4,38,42
2014,32,Everton,12,37,-3,39,42
2014,32,Newcastle,13,35,-16,33,49
2014,32,West Brom,14,33,-15,28,43
2014,32,Sunderland,15,29,-20,24,44
2014,32,Hull City,16,28,-14,29,43
2014,32,Aston Villa,17,28,-22,20,42
2014,32,Burnley,18,26,-23,26,49
2014,32,QPR,19,25,-20,35,55
2014,32,Leicester,20,22,-22,30,52
2014,33,Chelsea,1,76,40,67,27
2014,33,Arsenal,2,66,31,63,32
2014,33,Man Utd,3,65,29,59,30
2014,33,Man City,4,61,31,65,34
2014,33,Liverpool,5,57,11,47,36
2014,33,Southampton,6,56,22,44,22
2014,33,Spurs,7,54,4,50,46
2014,33,Swansea,8,47,-2,38,40
2014,33,West Ham,9,43,2,42,40
2014,33,Stoke City,10,43,-4,36,40
2014,33,Crystal Palace,11,42,-1,42,43
2014,33,Everton,12,38,-3,40,43
2014,33,Newcastle,13,35,-18,33,51
2014,33,West Brom,14,33,-16,30,46
2014,33,Aston Villa,15,31,-21,21,42
2014,33,Sunderland,16,29,-23,25,48
2014,33,Hull City,17,28,-16,29,45
2014,33,Burnley,18,26,-24,26,50
2014,33,QPR,19,25,-21,35,56
2014,33,Leicester,20,25,-21,33,54
2014,34,Chelsea,1,79,41,68,27
2014,34,Arsenal,2,67,31,63,32
2014,34,Man Utd,3,65,28,59,31
2014,34,Man City,4,64,33,67,34
2014,34,Liverpool,5,57,10,47,37
2014,34,Spurs,6,57,6,53,47
2014,34,Southampton,7,56,21,45,24
2014,34,Swansea,8,47,-4,38,42
2014,34,Stoke City,9,46,-3,38,41
2014,34,West Ham,10,43,0,42,42
2014,34,Crystal Palace,11,42,-3,42,45
2014,34,Everton,12,41,-2,41,43
2014,34,West Brom,13,36,-14,32,46
2014,34,Newcastle,14,35,-20,34,54
2014,34,Aston Villa,15,32,-21,24,45
2014,34,Hull City,16,31,-15,30,45
2014,34,Sunderland,17,30,-23,25,48
2014,34,Leicester,18,28,-19,35,54
2014,34,QPR,19,26,-21,38,59
2014,34,Burnley,20,26,-25,26,51
2014,35,Chelsea,1,80,41,68,27
2014,35,Arsenal,2,68,31,63,32
2014,35,Man City,3,67,34,70,36
2014,35,Man Utd,4,65,25,59,34
2014,35,Liverpool,5,58,10,47,37
2014,35,Spurs,6,58,6,55,49
2014,35,Southampton,7,57,21,47,26
2014,35,Swansea,8,50,-3,41,44
2014,35,Stoke City,9,47,-3,39,42
2014,35,Everton,10,44,1,44,43
2014,35,West Ham,11,44,0,42,42
2014,35,Crystal Palace,12,42,-5,42,47
2014,35,West Brom,13,37,-14,32,46
2014,35,Newcastle,14,35,-21,36,57
2014,35,Hull City,15,34,-13,32,45
2014,35,Aston Villa,16,32,-22,26,48
2014,35,Leicester,17,31,-18,36,54
2014,35,Sunderland,18,31,-23,26,49
2014,35,QPR,19,27,-21,38,59
2014,35,Burnley,20,26,-26,26,52
2014,36,Chelsea,1,83,42,69,27
2014,36,Arsenal,2,71,33,66,33
2014,36,Man City,3,70,35,71,36
2014,36,Man Utd,4,65,24,59,35
2014,36,Liverpool,5,61,11,49,38
2014,36,Spurs,6,58,5,55,50
2014,36,Southampton,7,57,20,48,28
2014,36,Swansea,8,53,-1,43,44
2014,36,West Ham,9,47,1,43,42
2014,36,Stoke City,10,47,-5,39,44
2014,36,Everton,11,44,0,46,46
2014,36,Crystal Palace,12,42,-6,42,48
2014,36,West Brom,13,40,-13,33,46
2014,36,Aston Villa,14,35,-21,29,50
2014,36,Newcastle,15,35,-24,36,60
2014,36,Leicester,16,34,-15,39,54
2014,36,Hull City,17,34,-15,33,48
2014,36,Sunderland,18,34,-22,28,50
2014,36,QPR,19,27,-22,39,61
2014,36,Burnley,20,26,-27,26,53
2014,37,Chelsea,1,84,42,70,28
2014,37,Man City,2,73,41,77,36
2014,37,Arsenal,3,71,32,66,34
2014,37,Man Utd,4,68,25,61,36
2014,37,Liverpool,5,62,11,50,39
2014,37,Spurs,6,58,2,55,53
2014,37,Southampton,7,57,18,48,30
2014,37,Swansea,8,56,0,44,44
2014,37,Stoke City,9,50,-2,42,44
2014,37,West Ham,10,47,0,43,43
2014,37,Everton,11,44,-2,46,48
2014,37,Crystal Palace,12,42,-7,43,50
2014,37,West Brom,13,41,-13,34,47
2014,37,Aston Villa,14,38,-20,30,50
2014,37,Leicester,15,37,-13,41,54
2014,37,Sunderland,16,37,-20,30,50
2014,37,Newcastle,17,36,-24,37,61
2014,37,Hull City,18,34,-16,33,49
2014,37,Burnley,19,29,-26,27,53
2014,37,QPR,20,27,-28,39,67
2014,38,Chelsea,1,84,39,70,31
2014,38,Man City,2,76,43,81,38
2014,38,Arsenal,3,72,32,67,35
2014,38,Man Utd,4,69,25,62,37
2014,38,Liverpool,5,62,9,51,42
2014,38,Spurs,6,61,4,57,53
2014,38,Southampton,7,60,23,54,31
2014,38,Swansea,8,56,-2,46,48
2014,38,Stoke City,9,51,-2,42,44
2014,38,Everton,10,47,-1,48,49
2014,38,West Ham,11,47,-1,44,45
2014,38,Crystal Palace,12,45,-5,46,51
2014,38,West Brom,13,44,-10,37,47
2014,38,Leicester,14,38,-13,41,54
2014,38,Sunderland,15,38,-20,30,50
2014,38,Aston Villa,16,38,-25,31,56
2014,38,Newcastle,17,36,-25,38,63
2014,38,Hull City,18,34,-18,33,51
2014,38,Burnley,19,30,-26,27,53
2014,38,QPR,20,30,-27,41,68
2014,39,Chelsea,1,87,41,73,32
2014,39,Man City,2,79,45,83,38
2014,39,Arsenal,3,75,35,71,36
2014,39,Man Utd,4,70,25,62,37
2014,39,Spurs,5,64,5,58,53
2014,39,Liverpool,6,62,4,52,48
2014,39,Southampton,7,60,21,54,33
2014,39,Swansea,8,56,-3,46,49
2014,39,Stoke City,9,54,3,48,45
2014,39,Crystal Palace,10,48,-4,47,51
2014,39,Everton,11,47,-2,48,50
2014,39,West Ham,12,47,-3,44,47
2014,39,West Brom,13,44,-13,38,51
2014,39,Leicester,14,41,-9,46,55
2014,39,Newcastle,15,39,-23,40,63
2014,39,Sunderland,16,38,-22,31,53
2014,39,Aston Villa,17,38,-26,31,57
2014,39,Hull City,18,35,-18,33,51
2014,39,Burnley,19,33,-25,28,53
2014,39,QPR,20,30,-31,42,73
2015,2,Man City,1,3,3,3,0
2015,2,Leicester,2,3,2,4,2
2015,2,Crystal Palace,3,3,2,3,1
2015,2,West Ham,4,3,2,2,0
2015,2,Man Utd,5,3,1,1,0
2015,2,Liverpool,6,3,1,1,0
2015,2,Aston Villa,7,3,1,1,0
2015,2,Chelsea,8,1,0,2,2
2015,2,Southampton,9,1,0,2,2
2015,2,Swansea,10,1,0,2,2
2015,2,Everton,11,1,0,2,2
2015,2,Newcastle,12,1,0,2,2
2015,2,Watford,13,1,0,2,2
2015,2,Spurs,14,0,-1,0,1
2015,2,Stoke City,15,0,-1,0,1
2015,2,Bournemouth,16,0,-1,0,1
2015,2,Sunderland,17,0,-2,2,4
2015,2,Norwich,18,0,-2,1,3
2015,2,Arsenal,19,0,-2,0,2
2015,2,West Brom,20,0,-3,0,3
2015,3,Man City,1,6,6,6,0
2015,3,Leicester,2,6,3,6,3
2015,3,Man Utd,3,6,2,2,0
2015,3,Liverpool,4,6,2,2,0
2015,3,Everton,5,4,3,5,2
2015,3,Swansea,6,4,2,4,2
2015,3,Crystal Palace,7,3,1,4,3
2015,3,West Ham,8,3,1,3,2
2015,3,Norwich,9,3,0,4,4
2015,3,Aston Villa,10,3,0,1,1
2015,3,Arsenal,11,3,-1,2,3
2015,3,Watford,12,2,0,2,2
2015,3,Spurs,13,1,-1,2,3
2015,3,Stoke City,14,1,-1,2,3
2015,3,Newcastle,15,1,-2,2,4
2015,3,Chelsea,16,1,-3,2,5
2015,3,Southampton,17,1,-3,2,5
2015,3,West Brom,18,1,-3,0,3
2015,3,Bournemouth,19,0,-2,0,2
2015,3,Sunderland,20,0,-4,3,7
2015,4,Man City,1,9,8,8,0
2015,4,Leicester,2,7,3,7,4
2015,4,Man Utd,3,7,2,2,0
2015,4,Liverpool,4,7,2,2,0
2015,4,Crystal Palace,5,6,2,6,4
2015,4,Swansea,6,5,2,5,3
2015,4,Everton,7,4,1,5,4
2015,4,Norwich,8,4,0,5,5
2015,4,Arsenal,9,4,-1,2,3
2015,4,Chelsea,10,4,-2,5,7
2015,4,West Ham,11,3,0,6,6
2015,4,Watford,12,3,0,2,2
2015,4,Bournemouth,13,3,-1,4,5
2015,4,Aston Villa,14,3,-1,2,3
2015,4,Spurs,15,2,-1,3,4
2015,4,Stoke City,16,2,-1,3,4
2015,4,Newcastle,17,2,-2,2,4
2015,4,Southampton,18,2,-3,2,5
2015,4,Sunderland,19,1,-4,4,8
2015,4,West Brom,20,1,-4,2,6
2015,5,Man City,1,12,10,10,0
2015,5,Crystal Palace,2,9,3,8,5
2015,5,Leicester,3,8,3,8,5
2015,5,Swansea,4,8,3,7,4
2015,5,Man Utd,5,7,1,3,2
2015,5,Arsenal,6,7,0,3,3
2015,5,Liverpool,7,7,-1,2,3
2015,5,West Ham,8,6,3,9,6
2015,5,Everton,9,5,1,5,4
2015,5,Southampton,10,5,0,5,5
2015,5,Bournemouth,11,4,-1,5,6
2015,5,Aston Villa,12,4,-1,4,5
2015,5,Chelsea,13,4,-3,6,9
2015,5,Norwich,14,4,-3,5,8
2015,5,West Brom,15,4,-3,3,6
2015,5,Spurs,16,3,-1,3,4
2015,5,Watford,17,3,-2,2,4
2015,5,Stoke City,18,2,-2,3,5
2015,5,Newcastle,19,2,-3,2,5
2015,5,Sunderland,20,2,-4,6,10
2015,6,Man City,1,15,11,11,0
2015,6,Leicester,2,11,4,11,7
2015,6,Man Utd,3,10,3,6,3
2015,6,Arsenal,4,10,2,5,3
2015,6,West Ham,5,9,5,11,6
2015,6,Crystal Palace,6,9,2,8,6
2015,6,Everton,7,8,3,8,5
2015,6,Swansea,8,8,2,7,5
2015,6,Norwich,9,7,-1,8,9
2015,6,Liverpool,10,7,-3,3,6
2015,6,Southampton,11,6,0,5,5
2015,6,Spurs,12,6,0,4,4
2015,6,Watford,13,6,-1,3,4
2015,6,West Brom,14,5,-3,3,6
2015,6,Aston Villa,15,4,-2,6,8
2015,6,Bournemouth,16,4,-3,6,9
2015,6,Chelsea,17,4,-5,7,12
2015,6,Stoke City,18,2,-4,3,7
2015,6,Sunderland,19,2,-5,6,11
2015,6,Newcastle,20,2,-5,2,7
2015,7,Man City,1,15,10,12,2
2015,7,Man Utd,2,13,4,9,5
2015,7,West Ham,3,12,6,13,7
2015,7,Leicester,4,12,4,13,9
2015,7,Arsenal,5,10,0,5,5
2015,7,Everton,6,9,3,8,5
2015,7,Swansea,7,9,2,7,5
2015,7,Crystal Palace,8,9,1,8,7
2015,7,Spurs,9,9,1,5,4
2015,7,Watford,10,9,0,5,5
2015,7,Norwich,11,8,-1,9,10
2015,7,West Brom,12,8,-2,4,6
2015,7,Liverpool,13,8,-3,4,7
2015,7,Bournemouth,14,7,-1,8,9
2015,7,Chelsea,15,7,-3,9,12
2015,7,Southampton,16,6,-1,7,8
2015,7,Aston Villa,17,4,-3,6,9
2015,7,Stoke City,18,3,-4,5,9
2015,7,Newcastle,19,2,-6,3,9
2015,7,Sunderland,20,2,-7,6,13
2015,8,Man Utd,1,16,7,12,5
2015,8,Man City,2,15,7,13,6
2015,8,West Ham,3,13,6,15,9
2015,8,Arsenal,4,13,3,10,7
2015,8,Everton,5,12,4,11,7
2015,8,Spurs,6,12,4,9,5
2015,8,Crystal Palace,7,12,2,9,7
2015,8,Leicester,8,12,1,15,14
2015,8,Liverpool,9,11,-2,7,9
2015,8,Southampton,10,9,1,10,9
2015,8,Swansea,11,9,0,8,8
2015,8,Norwich,12,9,-1,11,12
2015,8,Watford,13,9,-1,5,6
2015,8,Chelsea,14,8,-3,11,14
2015,8,West Brom,15,8,-3,6,9
2015,8,Bournemouth,16,7,-2,9,11
2015,8,Stoke City,17,6,-3,7,10
2015,8,Aston Villa,18,4,-4,8,12
2015,8,Newcastle,19,3,-6,5,11
2015,8,Sunderland,20,2,-10,6,16
2015,9,Man City,1,18,12,19,7
2015,9,Arsenal,2,16,6,13,7
2015,9,Man Utd,3,16,4,12,8
2015,9,Crystal Palace,4,15,4,11,7
2015,9,Leicester,5,15,2,17,15
2015,9,West Ham,6,14,6,17,11
2015,9,Everton,7,13,4,12,8
2015,9,Spurs,8,13,4,11,7
2015,9,Southampton,9,12,3,13,10
2015,9,Liverpool,10,12,-2,8,10
2015,9,Swansea,11,10,0,10,10
2015,9,Watford,12,10,-1,6,7
2015,9,Norwich,13,9,-2,12,14
2015,9,Stoke City,14,9,-2,8,10
2015,9,Bournemouth,15,8,-2,10,12
2015,9,Chelsea,16,8,-5,12,17
2015,9,West Brom,17,8,-5,6,11
2015,9,Aston Villa,18,4,-5,8,13
2015,9,Sunderland,19,3,-10,8,18
2015,9,Newcastle,20,3,-11,6,17
2015,10,Man City,1,21,16,24,8
2015,10,Arsenal,2,19,9,16,7
2015,10,Man Utd,3,19,7,15,8
2015,10,West Ham,4,17,8,20,12
2015,10,Leicester,5,16,2,19,17
2015,10,Crystal Palace,6,15,2,12,10
2015,10,Spurs,7,14,4,11,7
2015,10,Southampton,8,13,3,15,12
2015,10,Everton,9,13,1,12,11
2015,10,Liverpool,10,13,-2,8,10
2015,10,Stoke City,11,12,-1,9,10
2015,10,Chelsea,12,11,-3,14,17
2015,10,West Brom,13,11,-4,7,11
2015,10,Swansea,14,10,-1,10,11
2015,10,Watford,15,10,-4,6,10
2015,10,Norwich,16,9,-6,14,20
2015,10,Bournemouth,17,8,-6,11,17
2015,10,Newcastle,18,6,-7,12,19
2015,10,Aston Villa,19,4,-7,8,15
2015,10,Sunderland,20,3,-11,8,19
2015,11,Man City,1,22,16,24,8
2015,11,Arsenal,2,22,10,18,8
2015,11,West Ham,3,20,9,22,13
2015,11,Man Utd,4,20,7,15,8
2015,11,Leicester,5,19,3,20,17
2015,11,Spurs,6,17,8,16,8
2015,11,Crystal Palace,7,15,1,12,11
2015,11,Southampton,8,14,3,16,13
2015,11,Liverpool,9,14,-2,9,11
2015,11,West Brom,10,14,-3,8,11
2015,11,Everton,11,13,0,13,13
2015,11,Swansea,12,13,0,12,12
2015,11,Watford,13,13,-2,8,10
2015,11,Stoke City,14,12,-3,9,12
2015,11,Chelsea,15,11,-4,15,19
2015,11,Norwich,16,9,-7,14,21
2015,11,Bournemouth,17,8,-10,12,22
2015,11,Sunderland,18,6,-8,11,19
2015,11,Newcastle,19,6,-10,12,22
2015,11,Aston Villa,20,4,-8,9,17
2015,12,Man City,1,25,17,26,9
2015,12,Arsenal,2,25,13,21,8
2015,12,Leicester,3,22,4,23,19
2015,12,Man Utd,4,21,7,15,8
2015,12,Spurs,5,20,10,19,9
2015,12,West Ham,6,20,7,22,15
2015,12,Southampton,7,17,5,18,13
2015,12,Liverpool,8,17,0,12,12
2015,12,Everton,9,16,4,19,15
2015,12,Crystal Palace,10,16,1,12,11
2015,12,Watford,11,16,0,10,10
2015,12,West Brom,12,14,-4,10,14
2015,12,Swansea,13,13,-3,12,15
2015,12,Stoke City,14,13,-3,9,12
2015,12,Chelsea,15,11,-6,16,22
2015,12,Norwich,16,9,-8,15,23
2015,12,Bournemouth,17,8,-12,12,24
2015,12,Newcastle,18,7,-10,12,22
2015,12,Sunderland,19,6,-12,13,25
2015,12,Aston Villa,20,4,-10,10,20
2015,13,Man City,1,26,17,26,9
2015,13,Arsenal,2,26,13,22,9
2015,13,Leicester,3,25,5,25,20
2015,13,Man Utd,4,24,9,17,8
2015,13,Spurs,5,21,10,20,10
2015,13,West Ham,6,21,7,23,16
2015,13,Southampton,7,20,6,19,13
2015,13,Crystal Palace,8,19,2,14,12
2015,13,Everton,9,17,4,20,16
2015,13,Liverpool,10,17,-1,13,14
2015,13,Watford,11,16,-1,11,12
2015,13,Stoke City,12,16,-2,10,12
2015,13,West Brom,13,14,-6,10,16
2015,13,Swansea,14,13,-4,12,16
2015,13,Norwich,15,12,-7,16,23
2015,13,Chelsea,16,11,-7,16,23
2015,13,Newcastle,17,10,-9,13,22
2015,13,Bournemouth,18,8,-13,12,25
2015,13,Sunderland,19,6,-13,13,26
2015,13,Aston Villa,20,5,-10,10,20
2015,14,Leicester,1,28,8,28,20
2015,14,Man Utd,2,27,10,19,9
2015,14,Man City,3,26,14,27,13
2015,14,Arsenal,4,26,12,23,11
2015,14,Spurs,5,24,13,24,11
2015,14,West Ham,6,21,4,24,20
2015,14,Everton,7,20,8,24,16
2015,14,Southampton,8,20,5,19,14
2015,14,Liverpool,9,20,2,17,15
2015,14,Crystal Palace,10,19,1,14,13
2015,14,Stoke City,11,19,-1,11,12
2015,14,West Brom,12,17,-5,12,17
2015,14,Watford,13,16,-2,12,14
2015,14,Swansea,14,14,-4,14,18
2015,14,Chelsea,15,14,-6,17,23
2015,14,Norwich,16,12,-8,16,24
2015,14,Newcastle,17,10,-12,13,25
2015,14,Sunderland,18,9,-12,14,26
2015,14,Bournemouth,19,9,-13,14,27
2015,14,Aston Villa,20,5,-14,10,24
2015,15,Man City,1,29,16,30,14
2015,15,Leicester,2,29,8,29,21
2015,15,Man Utd,3,28,10,20,10
2015,15,Arsenal,4,27,12,24,12
2015,15,Spurs,5,25,13,24,11
2015,15,Liverpool,6,23,3,18,15
2015,15,Crystal Palace,7,22,5,19,14
2015,15,West Ham,8,22,4,25,21
2015,15,Everton,9,21,8,27,19
2015,15,Southampton,10,20,3,20,17
2015,15,Watford,11,19,-1,15,16
2015,15,Stoke City,12,19,-3,11,14
2015,15,West Brom,13,18,-5,13,18
2015,15,Chelsea,14,15,-6,17,23
2015,15,Swansea,15,14,-5,14,19
2015,15,Norwich,16,13,-8,17,25
2015,15,Sunderland,17,12,-10,16,26
2015,15,Bournemouth,18,10,-13,17,30
2015,15,Newcastle,19,10,-16,14,30
2015,15,Aston Villa,20,5,-15,12,27
2015,16,Leicester,1,32,11,32,21
2015,16,Arsenal,2,30,14,27,13
2015,16,Man City,3,29,14,30,16
2015,16,Man Utd,4,29,10,20,10
2015,16,Spurs,5,26,13,25,12
2015,16,Crystal Palace,6,23,5,20,15
2015,16,West Ham,7,23,4,25,21
2015,16,Liverpool,8,23,1,18,17
2015,16,Everton,9,22,8,28,20
2015,16,Watford,10,22,1,17,16
2015,16,Stoke City,11,22,-1,13,14
2015,16,Southampton,12,21,3,21,18
2015,16,West Brom,13,19,-5,14,19
2015,16,Chelsea,14,15,-7,17,24
2015,16,Swansea,15,14,-8,14,22
2015,16,Norwich,16,13,-10,17,27
2015,16,Bournemouth,17,13,-12,18,30
2015,16,Newcastle,18,13,-14,16,30
2015,16,Sunderland,19,12,-12,17,29
2015,16,Aston Villa,20,6,-15,13,28
2015,17,Leicester,1,35,12,34,22
2015,17,Arsenal,2,33,16,29,13
2015,17,Man City,3,32,15,32,17
2015,17,Man Utd,4,29,9,21,12
2015,17,Spurs,5,26,12,26,14
2015,17,Crystal Palace,6,26,6,21,15
2015,17,Watford,7,25,2,18,16
2015,17,West Ham,8,24,4,25,21
2015,17,Liverpool,9,24,1,20,19
2015,17,Everton,10,23,8,29,21
2015,17,Stoke City,11,23,-1,13,14
2015,17,Southampton,12,21,2,21,19
2015,17,West Brom,13,20,-5,16,21
2015,17,Bournemouth,14,16,-11,20,31
2015,17,Newcastle,15,16,-13,18,31
2015,17,Chelsea,16,15,-8,18,26
2015,17,Swansea,17,14,-9,15,24
2015,17,Norwich,18,14,-10,18,28
2015,17,Sunderland,19,12,-13,17,30
2015,17,Aston Villa,20,6,-17,13,30
2015,18,Leicester,1,38,13,37,24
2015,18,Arsenal,2,36,17,31,14
2015,18,Man City,3,32,14,33,19
2015,18,Spurs,4,29,14,28,14
2015,18,Man Utd,5,29,8,22,14
2015,18,Crystal Palace,6,29,7,23,16
2015,18,Watford,7,28,5,21,16
2015,18,West Ham,8,25,4,25,21
2015,18,Liverpool,9,24,-2,20,22
2015,18,Everton,10,23,7,31,24
2015,18,Stoke City,11,23,-2,14,16
2015,18,Southampton,12,21,0,21,21
2015,18,West Brom,13,20,-6,17,23
2015,18,Bournemouth,14,19,-10,22,32
2015,18,Chelsea,15,18,-6,21,27
2015,18,Norwich,16,17,-9,20,29
2015,18,Newcastle,17,17,-13,19,32
2015,18,Swansea,18,15,-9,15,24
2015,18,Sunderland,19,12,-15,18,33
2015,18,Aston Villa,20,7,-17,14,31
2015,19,Leicester,1,38,12,37,25
2015,19,Arsenal,2,36,13,31,18
2015,19,Man City,3,35,17,37,20
2015,19,Spurs,4,32,17,31,14
2015,19,Crystal Palace,5,30,7,23,16
2015,19,Man Utd,6,29,6,22,16
2015,19,Watford,7,29,5,23,18
2015,19,Liverpool,8,27,-1,21,22
2015,19,Everton,9,26,8,32,24
2015,19,West Ham,10,26,4,26,22
2015,19,Stoke City,11,26,0,16,16
2015,19,Southampton,12,24,4,25,21
2015,19,West Brom,13,20,-7,17,24
2015,19,Bournemouth,14,20,-10,22,32
2015,19,Chelsea,15,19,-6,23,29
2015,19,Swansea,16,18,-8,16,24
2015,19,Norwich,17,17,-12,20,32
2015,19,Newcastle,18,17,-14,19,33
2015,19,Sunderland,19,12,-18,19,37
2015,19,Aston Villa,20,8,-17,15,32
2015,20,Arsenal,1,39,15,33,18
2015,20,Leicester,2,39,12,37,25
2015,20,Man City,3,36,17,37,20
2015,20,Spurs,4,35,18,33,15
2015,20,Crystal Palace,5,31,7,23,16
2015,20,Man Utd,6,30,6,22,16
2015,20,Liverpool,7,30,0,22,22
2015,20,West Ham,8,29,5,28,23
2015,20,Watford,9,29,4,24,20
2015,20,Stoke City,10,29,1,20,19
2015,20,Everton,11,26,7,35,28
2015,20,Southampton,12,24,3,26,23
2015,20,West Brom,13,23,-6,18,24
2015,20,Chelsea,14,20,-6,23,29
2015,20,Norwich,15,20,-10,22,32
2015,20,Bournemouth,16,20,-12,22,34
2015,20,Swansea,17,19,-8,16,24
2015,20,Newcastle,18,17,-15,19,34
2015,20,Sunderland,19,12,-19,19,38
2015,20,Aston Villa,20,8,-19,15,34
2015,21,Arsenal,1,42,16,34,18
2015,21,Leicester,2,40,12,37,25
2015,21,Man City,3,39,18,39,21
2015,21,Spurs,4,36,18,34,16
2015,21,Man Utd,5,33,7,24,17
2015,21,West Ham,6,32,7,30,23
2015,21,Crystal Palace,7,31,4,23,19
2015,21,Liverpool,8,30,-2,22,24
2015,21,Watford,9,29,3,25,22
2015,21,Stoke City,10,29,0,21,21
2015,21,Everton,11,27,7,36,29
2015,21,West Brom,12,26,-5,20,25
2015,21,Southampton,13,24,2,26,24
2015,21,Chelsea,14,23,-3,26,29
2015,21,Norwich,15,23,-9,23,32
2015,21,Bournemouth,16,21,-12,22,34
2015,21,Swansea,17,19,-9,17,26
2015,21,Newcastle,18,17,-16,19,35
2015,21,Sunderland,19,15,-17,22,39
2015,21,Aston Villa,20,8,-21,16,37
2015,22,Arsenal,1,43,16,37,21
2015,22,Leicester,2,43,13,38,25
2015,22,Man City,3,40,18,39,21
2015,22,Spurs,4,36,17,34,17
2015,22,West Ham,5,35,9,33,24
2015,22,Man Utd,6,34,7,27,20
2015,22,Stoke City,7,32,2,24,22
2015,22,Crystal Palace,8,31,3,23,20
2015,22,Liverpool,9,31,-2,25,27
2015,22,Watford,10,29,1,25,24
2015,22,Everton,11,28,7,36,29
2015,22,Southampton,12,27,4,28,24
2015,22,West Brom,13,27,-5,22,27
2015,22,Chelsea,14,24,-3,28,31
2015,22,Norwich,15,23,-11,24,35
2015,22,Bournemouth,16,21,-14,23,37
2015,22,Swansea,17,19,-11,19,30
2015,22,Sunderland,18,18,-15,26,41
2015,22,Newcastle,19,18,-16,22,38
2015,22,Aston Villa,20,11,-20,17,37
2015,23,Arsenal,1,44,16,37,21
2015,23,Leicester,2,44,13,39,26
2015,23,Man City,3,43,22,43,21
2015,23,Spurs,4,39,20,38,18
2015,23,Man Utd,5,37,8,28,20
2015,23,West Ham,6,35,8,34,26
2015,23,Stoke City,7,33,2,24,22
2015,23,Crystal Palace,8,31,-1,23,24
2015,23,Liverpool,9,31,-3,25,28
2015,23,Southampton,10,30,7,31,24
2015,23,Everton,11,29,7,39,32
2015,23,Watford,12,29,0,25,25
2015,23,West Brom,13,27,-8,22,30
2015,23,Chelsea,14,25,-3,31,34
2015,23,Bournemouth,15,24,-11,26,37
2015,23,Norwich,16,23,-14,24,38
2015,23,Swansea,17,22,-10,20,30
2015,23,Newcastle,18,21,-15,24,39
2015,23,Sunderland,19,18,-18,27,45
2015,23,Aston Villa,20,12,-20,18,38
2015,24,Leicester,1,47,16,42,26
2015,24,Man City,2,44,22,45,23
2015,24,Arsenal,3,44,15,37,22
2015,24,Spurs,4,42,22,41,19
2015,24,Man Utd,5,37,7,28,21
2015,24,West Ham,6,36,8,36,28
2015,24,Liverpool,7,34,-2,30,32
2015,24,Southampton,8,33,8,32,24
2015,24,Stoke City,9,33,-1,24,25
2015,24,Watford,10,32,1,27,26
2015,24,Crystal Palace,11,31,-3,24,27
2015,24,Everton,12,29,6,40,34
2015,24,Chelsea,13,28,-2,32,34
2015,24,West Brom,14,28,-8,22,30
2015,24,Swansea,15,25,-9,22,31
2015,24,Bournemouth,16,25,-11,27,38
2015,24,Norwich,17,23,-15,28,43
2015,24,Newcastle,18,21,-16,25,41
2015,24,Sunderland,19,19,-18,28,46
2015,24,Aston Villa,20,13,-20,18,38
2015,25,Leicester,1,50,18,44,26
2015,25,Man City,2,47,23,46,23
2015,25,Spurs,3,45,25,44,19
2015,25,Arsenal,4,45,15,37,22
2015,25,Man Utd,5,40,10,31,21
2015,25,West Ham,6,39,10,38,28
2015,25,Southampton,7,34,8,32,24
2015,25,Liverpool,8,34,-4,30,34
2015,25,Watford,9,33,1,27,26
2015,25,Stoke City,10,33,-4,24,28
2015,25,Everton,11,32,9,43,34
2015,25,Crystal Palace,12,31,-4,25,29
2015,25,Chelsea,13,29,-2,32,34
2015,25,West Brom,14,29,-8,23,31
2015,25,Bournemouth,15,28,-10,29,39
2015,25,Swansea,16,26,-9,23,32
2015,25,Norwich,17,23,-18,28,46
2015,25,Newcastle,18,21,-19,25,44
2015,25,Sunderland,19,19,-19,28,47
2015,25,Aston Villa,20,13,-22,18,40
2015,26,Leicester,1,53,20,47,27
2015,26,Spurs,2,48,26,45,19
2015,26,Arsenal,3,48,17,39,22
2015,26,Man City,4,47,21,47,26
2015,26,Man Utd,5,41,10,32,22
2015,26,West Ham,6,39,9,38,29
2015,26,Southampton,7,37,9,33,24
2015,26,Everton,8,35,12,46,34
2015,26,Liverpool,9,35,-4,32,36
2015,26,Watford,10,33,0,27,27
2015,26,Stoke City,11,33,-7,24,31
2015,26,Crystal Palace,12,32,-4,26,30
2015,26,Chelsea,13,30,-2,33,35
2015,26,West Brom,14,29,-9,23,32
2015,26,Bournemouth,15,28,-12,29,41
2015,26,Swansea,16,27,-9,24,33
2015,26,Newcastle,17,24,-18,26,44
2015,26,Norwich,18,23,-20,28,48
2015,26,Sunderland,19,20,-19,30,49
2015,26,Aston Villa,20,16,-20,20,40
2015,27,Leicester,1,53,19,48,29
2015,27,Spurs,2,51,27,47,20
2015,27,Arsenal,3,51,18,41,23
2015,27,Man City,4,47,20,48,28
2015,27,Man Utd,5,41,9,33,24
2015,27,Southampton,6,40,10,34,24
2015,27,West Ham,7,40,9,40,31
2015,27,Liverpool,8,38,2,38,36
2015,27,Watford,9,36,1,29,28
2015,27,Stoke City,10,36,-5,27,32
2015,27,Everton,11,35,11,46,35
2015,27,Chelsea,12,33,2,38,36
2015,27,Crystal Palace,13,32,-5,27,32
2015,27,West Brom,14,32,-8,24,32
2015,27,Bournemouth,15,28,-14,30,44
2015,27,Swansea,16,27,-10,24,34
2015,27,Norwich,17,24,-20,30,50
2015,27,Newcastle,18,24,-22,27,49
2015,27,Sunderland,19,23,-18,32,50
2015,27,Aston Villa,20,16,-26,20,46
2015,28,Leicester,1,56,20,49,29
2015,28,Spurs,2,54,28,49,21
2015,28,Arsenal,3,51,17,43,26
2015,28,Man City,4,48,20,49,29
2015,28,Man Utd,5,44,10,36,26
2015,28,West Ham,6,43,10,41,31
2015,28,Liverpool,7,41,6,42,36
2015,28,Southampton,8,40,9,35,26
2015,28,Stoke City,9,39,-4,29,33
2015,28,Watford,10,37,1,29,28
2015,28,Chelsea,11,36,3,40,37
2015,28,Everton,12,35,7,46,39
2015,28,West Brom,13,35,-7,27,34
2015,28,Crystal Palace,14,32,-6,29,35
2015,28,Bournemouth,15,29,-14,30,44
2015,28,Swansea,16,27,-11,25,36
2015,28,Newcastle,17,25,-22,28,50
2015,28,Norwich,18,24,-21,30,51
2015,28,Sunderland,19,23,-19,32,51
2015,28,Aston Villa,20,16,-27,21,48
2015,29,Leicester,1,57,20,51,31
2015,29,Spurs,2,54,27,49,22
2015,29,Arsenal,3,51,16,44,28
2015,29,Man City,4,48,17,49,32
2015,29,Man Utd,5,47,11,37,26
2015,29,West Ham,6,46,11,42,31
2015,29,Liverpool,7,44,9,45,36
2015,29,Stoke City,8,42,-3,30,33
2015,29,Southampton,9,40,7,35,28
2015,29,Chelsea,10,39,4,42,38
2015,29,Everton,11,38,9,49,40
2015,29,Watford,12,37,0,29,29
2015,29,West Brom,13,36,-7,29,36
2015,29,Crystal Palace,14,33,-6,31,37
2015,29,Bournemouth,15,32,-12,32,44
2015,29,Swansea,16,30,-10,27,37
2015,29,Newcastle,17,25,-23,28,51
2015,29,Sunderland,18,24,-19,34,53
2015,29,Norwich,19,24,-22,31,53
2015,29,Aston Villa,20,16,-29,22,51
2015,30,Leicester,1,60,21,52,31
2015,30,Spurs,2,55,27,51,24
2015,30,Arsenal,3,52,16,46,30
2015,30,Man City,4,51,21,53,32
2015,30,West Ham,5,49,12,45,33
2015,30,Liverpool,6,47,10,47,37
2015,30,Man Utd,7,47,10,37,27
2015,30,Stoke City,8,43,-3,31,34
2015,30,Southampton,9,41,7,36,29
2015,30,Chelsea,10,40,4,43,39
2015,30,West Brom,11,39,-6,30,36
2015,30,Everton,12,38,8,51,43
2015,30,Watford,13,37,-1,29,30
2015,30,Bournemouth,14,35,-10,35,45
2015,30,Crystal Palace,15,33,-7,32,39
2015,30,Swansea,16,33,-9,28,37
2015,30,Sunderland,17,25,-19,35,54
2015,30,Newcastle,18,25,-25,29,54
2015,30,Norwich,19,24,-23,31,54
2015,30,Aston Villa,20,16,-33,22,55
2015,31,Leicester,1,63,22,53,31
2015,31,Spurs,2,58,29,53,24
2015,31,Arsenal,3,55,18,48,30
2015,31,Man City,4,52,21,53,32
2015,31,West Ham,5,52,14,48,34
2015,31,Man Utd,6,50,12,39,27
2015,31,Liverpool,7,48,10,48,38
2015,31,Southampton,8,44,8,38,30
2015,31,Stoke City,9,43,-4,32,36
2015,31,Chelsea,10,41,4,44,40
2015,31,West Brom,11,39,-8,30,38
2015,31,Everton,12,38,5,51,46
2015,31,Bournemouth,13,38,-9,38,47
2015,31,Watford,14,37,-3,30,33
2015,31,Crystal Palace,15,33,-9,32,41
2015,31,Swansea,16,33,-10,30,40
2015,31,Sunderland,17,28,-16,38,54
2015,31,Norwich,18,25,-23,31,54
2015,31,Newcastle,19,25,-26,29,55
2015,31,Aston Villa,20,16,-35,22,57
2015,32,Leicester,1,66,23,54,31
2015,32,Spurs,2,61,32,56,24
2015,32,Arsenal,3,58,20,50,30
2015,32,West Ham,4,53,14,50,36
2015,32,Man Utd,5,53,13,40,27
2015,32,Man City,6,52,20,53,33
2015,32,Liverpool,7,48,9,50,41
2015,32,Southampton,8,47,9,41,32
2015,32,Stoke City,9,46,-3,34,37
2015,32,Chelsea,10,42,4,46,42
2015,32,West Brom,11,39,-9,30,39
2015,32,Everton,12,38,3,51,48
2015,32,Bournemouth,13,38,-12,38,50
2015,32,Watford,14,37,-4,31,35
2015,32,Swansea,15,36,-9,31,40
2015,32,Crystal Palace,16,33,-10,32,42
2015,32,Sunderland,17,29,-16,39,55
2015,32,Norwich,18,28,-22,32,54
2015,32,Newcastle,19,26,-26,30,56
2015,32,Aston Villa,20,16,-36,22,58
2015,33,Leicester,1,69,24,55,31
2015,33,Spurs,2,62,32,57,25
2015,33,Arsenal,3,61,24,54,30
2015,33,Man Utd,4,56,14,41,27
2015,33,Man City,5,55,24,57,33
2015,33,West Ham,6,54,14,52,38
2015,33,Liverpool,7,49,9,51,42
2015,33,Southampton,8,47,8,41,33
2015,33,Stoke City,9,47,-3,36,39
2015,33,Chelsea,10,45,8,50,42
2015,33,West Brom,11,40,-9,30,39
2015,33,Everton,12,38,2,51,49
2015,33,Bournemouth,13,38,-16,38,54
2015,33,Watford,14,37,-8,31,39
2015,33,Swansea,15,37,-9,33,42
2015,33,Crystal Palace,16,34,-10,34,44
2015,33,Norwich,17,31,-21,35,56
2015,33,Sunderland,18,30,-16,39,55
2015,33,Newcastle,19,26,-27,32,59
2015,33,Aston Villa,20,16,-40,22,62
2015,34,Leicester,1,72,26,57,31
2015,34,Spurs,2,65,35,60,25
2015,34,Arsenal,3,62,24,57,33
2015,34,Man City,4,58,25,59,34
2015,34,Man Utd,5,56,11,41,30
2015,34,West Ham,6,55,14,55,41
2015,34,Liverpool,7,52,12,55,43
2015,34,Southampton,8,50,10,44,34
2015,34,Stoke City,9,47,-6,37,43
2015,34,Chelsea,10,45,7,50,43
2015,34,Bournemouth,11,41,-15,40,55
2015,34,Swansea,12,40,-8,34,42
2015,34,West Brom,13,40,-10,31,41
2015,34,Everton,14,39,2,52,50
2015,34,Watford,15,38,-8,32,40
2015,34,Crystal Palace,16,37,-9,35,44
2015,34,Norwich,17,31,-22,35,57
2015,34,Sunderland,18,30,-18,39,57
2015,34,Newcastle,19,26,-29,33,62
2015,34,Aston Villa,20,16,-41,23,64
2015,35,Leicester,1,73,26,59,33
2015,35,Spurs,2,68,39,64,25
2015,35,Arsenal,3,63,24,58,34
2015,35,Man City,4,61,28,62,34
2015,35,Man Utd,5,59,12,42,30
2015,35,West Ham,6,56,14,57,43
2015,35,Liverpool,7,55,13,57,44
2015,35,Southampton,8,51,10,45,35
2015,35,Stoke City,9,47,-10,37,47
2015,35,Chelsea,10,45,4,50,46
2015,35,Watford,11,41,-7,33,40
2015,35,Bournemouth,12,41,-16,41,57
2015,35,Everton,13,40,2,53,51
2015,35,Swansea,14,40,-11,34,45
2015,35,West Brom,15,40,-11,31,42
2015,35,Crystal Palace,16,38,-9,36,45
2015,35,Sunderland,17,33,-15,42,57
2015,35,Norwich,18,31,-25,35,60
2015,35,Newcastle,19,29,-26,36,62
2015,35,Aston Villa,20,16,-42,23,65
2015,36,Leicester,1,76,30,63,33
2015,36,Spurs,2,69,39,65,26
2015,36,Man City,3,64,32,66,34
2015,36,Arsenal,4,64,24,58,34
2015,36,West Ham,5,59,15,60,45
2015,36,Man Utd,6,59,11,44,33
2015,36,Liverpool,7,56,13,59,46
2015,36,Southampton,8,54,12,49,37
2015,36,Chelsea,9,48,7,54,47
2015,36,Stoke City,10,47,-14,37,51
2015,36,Everton,11,41,2,53,51
2015,36,Watford,12,41,-9,35,44
2015,36,West Brom,13,41,-11,32,43
2015,36,Bournemouth,14,41,-19,42,61
2015,36,Swansea,15,40,-15,34,49
2015,36,Crystal Palace,16,39,-9,36,45
2015,36,Sunderland,17,34,-15,42,57
2015,36,Norwich,18,34,-23,39,62
2015,36,Newcastle,19,30,-26,38,64
2015,36,Aston Villa,20,16,-44,25,69
2015,37,Leicester,1,77,30,64,34
2015,37,Spurs,2,70,39,67,28
2015,37,Arsenal,3,67,25,59,34
2015,37,Man City,4,64,30,68,38
2015,37,West Ham,5,62,18,63,45
2015,37,Man Utd,6,60,11,45,34
2015,37,Southampton,7,57,14,53,39
2015,37,Liverpool,8,56,11,60,49
2015,37,Chelsea,9,49,7,56,49
2015,37,Stoke City,10,48,-14,38,52
2015,37,Everton,11,44,3,55,52
2015,37,Watford,12,44,-8,38,46
2015,37,Swansea,13,43,-13,37,50
2015,37,West Brom,14,41,-14,32,46
2015,37,Bournemouth,15,41,-20,43,63
2015,37,Crystal Palace,16,39,-10,36,46
2015,37,Sunderland,17,35,-15,43,58
2015,37,Norwich,18,34,-24,39,63
2015,37,Newcastle,19,33,-25,39,64
2015,37,Aston Villa,20,16,-45,27,72
2015,38,Leicester,1,80,32,67,35
2015,38,Spurs,2,70,38,68,30
2015,38,Arsenal,3,68,25,61,36
2015,38,Man City,4,65,30,70,40
2015,38,Man Utd,5,63,12,46,34
2015,38,West Ham,6,62,15,64,49
2015,38,Southampton,7,60,15,55,40
2015,38,Liverpool,8,59,13,62,49
2015,38,Chelsea,9,49,6,58,52
2015,38,Stoke City,10,48,-15,39,54
2015,38,Swansea,11,46,-10,41,51
2015,38,Everton,12,44,1,56,55
2015,38,Watford,13,44,-10,38,48
2015,38,Crystal Palace,14,42,-9,38,47
2015,38,West Brom,15,42,-14,33,47
2015,38,Bournemouth,16,42,-20,44,64
2015,38,Sunderland,17,38,-14,46,60
2015,38,Newcastle,18,34,-25,39,64
2015,38,Norwich,19,34,-25,39,64
2015,38,Aston Villa,20,17,-45,27,72
2015,39,Leicester,1,81,32,68,36
2015,39,Arsenal,2,71,29,65,36
2015,39,Spurs,3,70,34,69,35
2015,39,Man City,4,66,30,71,41
2015,39,Man Utd,5,66,14,49,35
2015,39,Southampton,6,63,18,59,41
2015,39,West Ham,7,62,14,65,51
2015,39,Liverpool,8,60,13,63,50
2015,39,Stoke City,9,51,-14,41,55
2015,39,Chelsea,10,50,6,59,53
2015,39,Everton,11,47,4,59,55
2015,39,Swansea,12,47,-10,42,52
2015,39,Watford,13,45,-10,40,50
2015,39,West Brom,14,43,-14,34,48
2015,39,Crystal Palace,15,42,-12,39,51
2015,39,Bournemouth,16,42,-22,45,67
2015,39,Sunderland,17,39,-14,48,62
2015,39,Newcastle,18,37,-21,44,65
2015,39,Norwich,19,34,-28,39,67
2015,39,Aston Villa,20,17,-49,27,76
2016,2,Man Utd,1,3,2,3,1
2016,2,Liverpool,2,3,1,4,3
2016,2,Man City,3,3,1,2,1
2016,2,Chelsea,4,3,1,2,1
2016,2,Hull City,5,3,1,2,1
2016,2,Swansea,6,3,1,1,0
2016,2,West Brom,7,3,1,1,0
2016,2,Spurs,8,1,0,1,1
2016,2,Southampton,9,1,0,1,1
2016,2,Stoke City,10,1,0,1,1
2016,2,Everton,11,1,0,1,1
2016,2,Watford,12,1,0,1,1
2016,2,Middlesbrough,13,1,0,1,1
2016,2,Arsenal,14,0,-1,3,4
2016,2,Leicester,15,0,-1,1,2
2016,2,West Ham,16,0,-1,1,2
2016,2,Sunderland,17,0,-1,1,2
2016,2,Crystal Palace,18,0,-1,0,1
2016,2,Burnley,19,0,-1,0,1
2016,2,Bournemouth,20,0,-2,1,3
2016,3,Man City,1,6,4,6,2
2016,3,Man Utd,2,6,4,5,1
2016,3,Hull City,3,6,3,4,1
2016,3,Chelsea,4,6,2,4,2
2016,3,Everton,5,4,1,3,2
2016,3,Middlesbrough,6,4,1,3,2
2016,3,Spurs,7,4,1,2,1
2016,3,Burnley,8,3,1,2,1
2016,3,West Ham,9,3,0,2,2
2016,3,West Brom,10,3,0,2,2
2016,3,Liverpool,11,3,-1,4,5
2016,3,Swansea,12,3,-1,1,2
2016,3,Arsenal,13,1,-1,3,4
2016,3,Watford,14,1,-1,2,3
2016,3,Leicester,15,1,-1,1,2
2016,3,Southampton,16,1,-2,1,3
2016,3,Stoke City,17,1,-3,2,5
2016,3,Sunderland,18,0,-2,2,4
2016,3,Crystal Palace,19,0,-2,0,2
2016,3,Bournemouth,20,0,-3,1,4
2016,4,Man City,1,9,6,9,3
2016,4,Chelsea,2,9,5,7,2
2016,4,Man Utd,3,9,5,6,1
2016,4,Everton,4,7,2,4,2
2016,4,Hull City,5,6,2,4,2
2016,4,Spurs,6,5,1,3,2
2016,4,Middlesbrough,7,5,1,3,2
2016,4,Arsenal,8,4,1,6,5
2016,4,Leicester,9,4,0,3,3
2016,4,West Brom,10,4,0,2,2
2016,4,Liverpool,11,4,-1,5,6
2016,4,West Ham,12,3,-2,3,5
2016,4,Swansea,13,3,-2,2,4
2016,4,Burnley,14,3,-2,2,4
2016,4,Southampton,15,2,-2,2,4
2016,4,Sunderland,16,1,-2,3,5
2016,4,Crystal Palace,17,1,-2,1,3
2016,4,Watford,18,1,-3,3,6
2016,4,Bournemouth,19,1,-3,2,5
2016,4,Stoke City,20,1,-4,2,6
2016,5,Man City,1,12,7,11,4
2016,5,Chelsea,2,10,5,9,4
2016,5,Everton,3,10,5,7,2
2016,5,Man Utd,4,9,4,7,3
2016,5,Spurs,5,8,5,7,2
2016,5,Liverpool,6,7,2,9,7
2016,5,Arsenal,7,7,2,8,6
2016,5,Hull City,8,7,2,5,3
2016,5,Middlesbrough,9,5,0,4,4
2016,5,Watford,10,4,-1,7,8
2016,5,Crystal Palace,11,4,-1,3,4
2016,5,West Brom,12,4,-1,2,3
2016,5,Swansea,13,4,-2,4,6
2016,5,Bournemouth,14,4,-2,3,5
2016,5,Burnley,15,4,-2,3,5
2016,5,Leicester,16,4,-3,4,7
2016,5,West Ham,17,3,-4,5,9
2016,5,Southampton,18,2,-3,3,6
2016,5,Sunderland,19,1,-5,3,8
2016,5,Stoke City,20,1,-8,2,10
2016,6,Man City,1,15,11,15,4
2016,6,Everton,2,13,7,10,3
2016,6,Spurs,3,11,6,8,2
2016,6,Arsenal,4,10,5,12,7
2016,6,Chelsea,5,10,4,10,6
2016,6,Liverpool,6,10,3,11,8
2016,6,Man Utd,7,9,2,8,6
2016,6,Crystal Palace,8,7,2,7,5
2016,6,Watford,9,7,1,10,9
2016,6,West Brom,10,7,1,6,5
2016,6,Leicester,11,7,0,7,7
2016,6,Hull City,12,7,-1,6,7
2016,6,Middlesbrough,13,5,-2,5,7
2016,6,Southampton,14,5,-2,4,6
2016,6,Swansea,15,4,-3,4,7
2016,6,Burnley,16,4,-5,3,8
2016,6,Bournemouth,17,4,-6,3,9
2016,6,West Ham,18,3,-6,7,13
2016,6,Sunderland,19,1,-6,3,9
2016,6,Stoke City,20,1,-11,3,14
2016,7,Man City,1,18,13,18,5
2016,7,Spurs,2,14,7,10,3
2016,7,Arsenal,3,13,8,15,7
2016,7,Liverpool,4,13,7,16,9
2016,7,Everton,5,13,6,10,4
2016,7,Man Utd,6,12,5,12,7
2016,7,Crystal Palace,7,10,3,10,7
2016,7,Chelsea,8,10,1,10,9
2016,7,Southampton,9,8,1,7,6
2016,7,West Brom,10,8,1,7,6
2016,7,Watford,11,7,-1,10,11
2016,7,Leicester,12,7,-3,8,11
2016,7,Burnley,13,7,-3,5,8
2016,7,Hull City,14,7,-5,7,12
2016,7,Bournemouth,15,7,-5,4,9
2016,7,Middlesbrough,16,5,-3,6,9
2016,7,Swansea,17,4,-5,5,10
2016,7,West Ham,18,3,-9,7,16
2016,7,Stoke City,19,2,-11,4,15
2016,7,Sunderland,20,1,-7,5,12
2016,8,Man City,1,18,11,18,7
2016,8,Spurs,2,17,9,12,3
2016,8,Arsenal,3,16,9,16,7
2016,8,Liverpool,4,16,8,18,10
2016,8,Everton,5,14,6,11,5
2016,8,Man Utd,6,13,5,13,8
2016,8,Chelsea,7,13,3,12,9
2016,8,Crystal Palace,8,11,3,11,8
2016,8,West Brom,9,9,1,8,7
2016,8,Southampton,10,9,1,7,6
2016,8,Watford,11,8,-1,12,13
2016,8,Leicester,12,8,-3,8,11
2016,8,Bournemouth,13,8,-5,6,11
2016,8,Burnley,14,7,-4,5,9
2016,8,Hull City,15,7,-7,7,14
2016,8,Middlesbrough,16,6,-3,7,10
2016,8,Swansea,17,4,-6,6,12
2016,8,West Ham,18,4,-9,8,17
2016,8,Stoke City,19,3,-11,5,16
2016,8,Sunderland,20,2,-7,6,13
2016,9,Man City,1,19,11,19,8
2016,9,Arsenal,2,19,10,19,9
2016,9,Spurs,3,18,9,13,4
2016,9,Liverpool,4,17,8,18,10
2016,9,Chelsea,5,16,6,15,9
2016,9,Everton,6,15,6,12,6
2016,9,Man Utd,7,14,5,13,8
2016,9,Southampton,8,12,3,10,7
2016,9,Crystal Palace,9,11,2,11,9
2016,9,Watford,10,11,0,13,13
2016,9,Bournemouth,11,11,0,12,12
2016,9,West Brom,12,10,1,9,8
2016,9,Leicester,13,8,-6,8,14
2016,9,Burnley,14,7,-6,6,12
2016,9,West Ham,15,7,-8,9,17
2016,9,Hull City,16,7,-12,8,20
2016,9,Middlesbrough,17,6,-4,7,11
2016,9,Stoke City,18,6,-9,7,16
2016,9,Swansea,19,4,-7,8,15
2016,9,Sunderland,20,2,-9,6,15
2016,10,Man City,1,20,11,20,9
2016,10,Arsenal,2,20,10,19,9
2016,10,Liverpool,3,20,9,20,11
2016,10,Chelsea,4,19,10,19,9
2016,10,Spurs,5,19,9,13,4
2016,10,Everton,6,15,5,13,8
2016,10,Man Utd,7,14,1,13,12
2016,10,Southampton,8,13,3,11,8
2016,10,Watford,9,12,0,13,13
2016,10,Bournemouth,10,12,0,12,12
2016,10,Crystal Palace,11,11,0,12,12
2016,10,Leicester,12,11,-4,11,15
2016,10,West Brom,13,10,0,10,10
2016,10,Burnley,14,10,-5,8,13
2016,10,West Ham,15,10,-7,10,17
2016,10,Stoke City,16,9,-7,9,16
2016,10,Middlesbrough,17,7,-4,7,11
2016,10,Hull City,18,7,-14,8,22
2016,10,Swansea,19,5,-7,8,15
2016,10,Sunderland,20,2,-10,6,16
2016,11,Man City,1,23,15,24,9
2016,11,Arsenal,2,23,13,23,10
2016,11,Liverpool,3,23,11,24,13
2016,11,Chelsea,4,22,12,21,9
2016,11,Spurs,5,20,9,14,5
2016,11,Everton,6,18,7,15,8
2016,11,Watford,7,15,1,14,13
2016,11,Man Utd,8,15,1,13,12
2016,11,Southampton,9,13,1,11,10
2016,11,Bournemouth,10,12,-2,12,14
2016,11,Leicester,11,12,-4,12,16
2016,11,Stoke City,12,12,-5,12,17
2016,11,Crystal Palace,13,11,-2,14,16
2016,11,Burnley,14,11,-5,8,13
2016,11,Middlesbrough,15,10,-2,9,11
2016,11,West Brom,16,10,-4,10,14
2016,11,West Ham,17,10,-9,10,19
2016,11,Hull City,18,7,-15,8,23
2016,11,Swansea,19,5,-9,9,18
2016,11,Sunderland,20,2,-13,7,20
2016,12,Liverpool,1,26,16,30,14
2016,12,Chelsea,2,25,17,26,9
2016,12,Man City,3,24,15,25,10
2016,12,Arsenal,4,24,13,24,11
2016,12,Spurs,5,21,9,15,6
2016,12,Man Utd,6,18,3,16,13
2016,12,Everton,7,18,2,15,13
2016,12,Watford,8,15,-4,15,19
2016,12,Burnley,9,14,-4,11,15
2016,12,Southampton,10,13,0,12,12
2016,12,West Brom,11,13,-3,12,15
2016,12,Stoke City,12,13,-5,13,18
2016,12,Bournemouth,13,12,-3,13,16
2016,12,Leicester,14,12,-5,13,18
2016,12,Middlesbrough,15,11,-2,10,12
2016,12,Crystal Palace,16,11,-3,16,19
2016,12,West Ham,17,11,-9,11,20
2016,12,Hull City,18,10,-14,10,24
2016,12,Swansea,19,5,-11,10,21
2016,12,Sunderland,20,5,-12,9,21
2016,13,Chelsea,1,28,18,27,9
2016,13,Liverpool,2,27,16,30,14
2016,13,Man City,3,27,16,27,11
2016,13,Arsenal,4,25,13,25,12
2016,13,Spurs,5,24,10,18,8
2016,13,Man Utd,6,19,3,17,14
2016,13,Everton,7,19,2,16,14
2016,13,Watford,8,18,-3,17,20
2016,13,West Brom,9,16,1,16,15
2016,13,Bournemouth,10,15,-2,14,16
2016,13,Southampton,11,14,0,12,12
2016,13,Burnley,12,14,-8,11,19
2016,13,Stoke City,13,13,-6,13,19
2016,13,Leicester,14,12,-6,14,20
2016,13,Middlesbrough,15,11,-3,10,13
2016,13,Crystal Palace,16,11,-4,17,21
2016,13,West Ham,17,11,-10,13,23
2016,13,Hull City,18,10,-17,10,27
2016,13,Sunderland,19,8,-9,12,21
2016,13,Swansea,20,6,-11,11,22
2016,14,Chelsea,1,31,19,29,10
2016,14,Liverpool,2,30,18,32,14
2016,14,Man City,3,30,17,29,12
2016,14,Arsenal,4,28,15,28,13
2016,14,Spurs,5,24,9,19,10
2016,14,Man Utd,6,20,3,18,15
2016,14,Everton,7,19,1,16,15
2016,14,Watford,8,18,-4,17,21
2016,14,West Brom,9,17,1,17,16
2016,14,Southampton,10,17,1,13,12
2016,14,Stoke City,11,16,-5,14,19
2016,14,Bournemouth,12,15,-4,15,19
2016,14,Burnley,13,14,-9,12,21
2016,14,Leicester,14,13,-6,16,22
2016,14,Middlesbrough,15,12,-3,12,15
2016,14,West Ham,16,12,-10,14,24
2016,14,Crystal Palace,17,11,-5,21,26
2016,14,Hull City,18,11,-17,11,28
2016,14,Swansea,19,9,-10,16,26
2016,14,Sunderland,20,8,-11,12,23
2016,15,Chelsea,1,34,21,32,11
2016,15,Arsenal,2,31,19,33,14
2016,15,Liverpool,3,30,17,35,18
2016,15,Man City,4,30,15,30,15
2016,15,Spurs,5,27,14,24,10
2016,15,Man Utd,6,21,3,19,16
2016,15,West Brom,7,20,3,20,17
2016,15,Everton,8,20,1,17,16
2016,15,Stoke City,9,19,-3,16,19
2016,15,Bournemouth,10,18,-3,19,22
2016,15,Watford,11,18,-6,18,24
2016,15,Southampton,12,17,-2,13,15
2016,15,Middlesbrough,13,15,-2,13,15
2016,15,Crystal Palace,14,14,-2,24,26
2016,15,Burnley,15,14,-11,12,23
2016,15,Leicester,16,13,-7,17,24
2016,15,West Ham,17,12,-14,15,29
2016,15,Sunderland,18,11,-10,14,24
2016,15,Hull City,19,11,-18,11,29
2016,15,Swansea,20,9,-15,16,31
2016,16,Chelsea,1,37,22,33,11
2016,16,Arsenal,2,34,21,36,15
2016,16,Liverpool,3,31,17,37,20
2016,16,Man City,4,30,13,32,19
2016,16,Spurs,5,27,13,24,11
2016,16,Man Utd,6,24,4,20,16
2016,16,Watford,7,21,-5,21,26
2016,16,West Brom,8,20,2,20,18
2016,16,Everton,9,20,0,19,19
2016,16,Southampton,10,20,-1,14,15
2016,16,Stoke City,11,19,-5,17,22
2016,16,Bournemouth,12,18,-4,21,25
2016,16,Burnley,13,17,-10,15,25
2016,16,Leicester,14,16,-5,21,26
2016,16,Crystal Palace,15,15,-2,27,29
2016,16,Middlesbrough,16,15,-3,13,16
2016,16,West Ham,17,13,-14,17,31
2016,16,Swansea,18,12,-12,19,31
2016,16,Hull City,19,12,-18,14,32
2016,16,Sunderland,20,11,-13,14,27
2016,17,Chelsea,1,40,23,34,11
2016,17,Liverpool,2,34,20,40,20
2016,17,Arsenal,3,34,20,37,17
2016,17,Man City,4,33,15,34,19
2016,17,Spurs,5,30,16,27,11
2016,17,Man Utd,6,27,5,22,17
2016,17,West Brom,7,23,4,23,19
2016,17,Everton,8,23,1,21,20
2016,17,Southampton,9,21,-1,14,15
2016,17,Bournemouth,10,21,-3,22,25
2016,17,Watford,11,21,-7,21,28
2016,17,Stoke City,12,20,-5,17,22
2016,17,Burnley,13,17,-11,15,26
2016,17,Leicester,14,16,-6,21,27
2016,17,West Ham,15,16,-13,18,31
2016,17,Crystal Palace,16,15,-3,28,31
2016,17,Middlesbrough,17,15,-6,13,19
2016,17,Swansea,18,12,-14,20,34
2016,17,Hull City,19,12,-21,14,35
2016,17,Sunderland,20,11,-14,14,28
2016,18,Chelsea,1,43,24,35,11
2016,18,Liverpool,2,37,21,41,20
2016,18,Man City,3,36,16,36,20
2016,18,Arsenal,4,34,19,38,19
2016,18,Spurs,5,33,17,29,12
2016,18,Man Utd,6,30,7,24,17
2016,18,Southampton,7,24,1,17,16
2016,18,West Brom,8,23,2,23,21
2016,18,Everton,9,23,0,21,21
2016,18,Bournemouth,10,21,-5,23,28
2016,18,Stoke City,11,21,-5,19,24
2016,18,Watford,12,21,-8,21,29
2016,18,West Ham,13,19,-12,19,31
2016,18,Middlesbrough,14,18,-3,16,19
2016,18,Leicester,15,17,-6,23,29
2016,18,Burnley,16,17,-12,16,28
2016,18,Crystal Palace,17,15,-4,28,32
2016,18,Sunderland,18,14,-13,15,28
2016,18,Swansea,19,12,-17,20,37
2016,18,Hull City,20,12,-22,14,36
2016,19,Chelsea,1,46,27,38,11
2016,19,Liverpool,2,40,24,45,21
2016,19,Man City,3,39,19,39,20
2016,19,Arsenal,4,37,20,39,19
2016,19,Spurs,5,36,20,33,13
2016,19,Man Utd,6,33,9,27,18
2016,19,Everton,7,26,2,23,21
2016,19,Southampton,8,24,-2,18,20
2016,19,West Brom,9,23,1,23,22
2016,19,Watford,10,22,-8,22,30
2016,19,West Ham,11,22,-9,23,32
2016,19,Bournemouth,12,21,-8,23,31
2016,19,Stoke City,13,21,-8,20,28
2016,19,Burnley,14,20,-11,17,28
2016,19,Middlesbrough,15,18,-4,16,20
2016,19,Leicester,16,17,-8,23,31
2016,19,Crystal Palace,17,16,-4,29,33
2016,19,Sunderland,18,14,-15,16,31
2016,19,Swansea,19,12,-20,21,41
2016,19,Hull City,20,12,-25,14,39
2016,20,Chelsea,1,49,29,42,13
2016,20,Liverpool,2,43,25,46,21
2016,20,Arsenal,3,40,22,41,19
2016,20,Spurs,4,39,23,37,14
2016,20,Man City,5,39,18,39,21
2016,20,Man Utd,6,36,10,29,19
2016,20,Everton,7,27,2,25,23
2016,20,West Brom,8,26,2,25,23
2016,20,Southampton,9,24,-3,19,22
2016,20,Bournemouth,10,24,-5,26,31
2016,20,Burnley,11,23,-8,21,29
2016,20,West Ham,12,22,-10,23,33
2016,20,Watford,13,22,-11,23,34
2016,20,Stoke City,14,21,-10,22,32
2016,20,Leicester,15,20,-7,24,31
2016,20,Middlesbrough,16,18,-5,17,22
2016,20,Crystal Palace,17,16,-6,29,35
2016,20,Sunderland,18,14,-18,17,35
2016,20,Hull City,19,13,-25,16,41
2016,20,Swansea,20,12,-23,21,44
2016,21,Chelsea,1,49,27,42,15
2016,21,Liverpool,2,44,25,48,23
2016,21,Spurs,3,42,25,39,14
2016,21,Man City,4,42,19,41,22
2016,21,Arsenal,5,41,22,44,22
2016,21,Man Utd,6,39,12,31,19
2016,21,Everton,7,30,5,28,23
2016,21,West Brom,8,29,4,28,24
2016,21,Bournemouth,9,25,-5,29,34
2016,21,Southampton,10,24,-6,19,25
2016,21,Stoke City,11,24,-8,24,32
2016,21,Burnley,12,23,-9,22,31
2016,21,West Ham,13,22,-12,23,35
2016,21,Watford,14,22,-13,23,36
2016,21,Leicester,15,21,-7,24,31
2016,21,Middlesbrough,16,19,-5,17,22
2016,21,Crystal Palace,17,16,-7,30,37
2016,21,Sunderland,18,15,-18,19,37
2016,21,Swansea,19,15,-22,23,45
2016,21,Hull City,20,13,-27,17,44
2016,22,Chelsea,1,52,30,45,15
2016,22,Spurs,2,45,29,43,14
2016,22,Liverpool,3,45,25,49,24
2016,22,Arsenal,4,44,26,48,22
2016,22,Man City,5,42,15,41,26
2016,22,Man Utd,6,40,12,32,20
2016,22,Everton,7,33,9,32,23
2016,22,West Brom,8,29,0,28,28
2016,22,Stoke City,9,27,-6,27,33
2016,22,Burnley,10,26,-8,23,31
2016,22,Bournemouth,11,25,-7,30,37
2016,22,West Ham,12,25,-9,26,35
2016,22,Southampton,13,24,-7,19,26
2016,22,Watford,14,23,-13,23,36
2016,22,Leicester,15,21,-10,24,34
2016,22,Middlesbrough,16,20,-5,17,22
2016,22,Crystal Palace,17,16,-10,30,40
2016,22,Hull City,18,16,-25,20,45
2016,22,Sunderland,19,15,-20,20,40
2016,22,Swansea,20,15,-26,23,49
2016,23,Chelsea,1,55,32,47,15
2016,23,Arsenal,2,47,27,50,23
2016,23,Spurs,3,46,29,45,16
2016,23,Liverpool,4,45,24,51,27
2016,23,Man City,5,43,15,43,28
2016,23,Man Utd,6,41,12,33,21
2016,23,Everton,7,36,10,33,23
2016,23,West Brom,8,32,2,30,28
2016,23,Stoke City,9,28,-6,28,34
2016,23,West Ham,10,28,-7,29,36
2016,23,Southampton,11,27,-4,22,26
2016,23,Bournemouth,12,26,-7,32,39
2016,23,Burnley,13,26,-9,24,33
2016,23,Watford,14,24,-13,25,38
2016,23,Leicester,15,21,-13,24,37
2016,23,Middlesbrough,16,20,-7,18,25
2016,23,Swansea,17,18,-25,26,51
2016,23,Crystal Palace,18,16,-11,30,41
2016,23,Hull City,19,16,-27,20,47
2016,23,Sunderland,20,15,-22,20,42
2016,24,Chelsea,1,56,32,48,16
2016,24,Spurs,2,47,29,45,16
2016,24,Arsenal,3,47,26,51,25
2016,24,Liverpool,4,46,24,52,28
2016,24,Man City,5,46,19,47,28
2016,24,Man Utd,6,42,12,33,21
2016,24,Everton,7,37,10,34,24
2016,24,West Brom,8,33,2,31,29
2016,24,Stoke City,9,29,-6,29,35
2016,24,Burnley,10,29,-8,25,33
2016,24,West Ham,11,28,-11,29,40
2016,24,Southampton,12,27,-5,23,28
2016,24,Watford,13,27,-12,27,39
2016,24,Bournemouth,14,26,-9,32,41
2016,24,Middlesbrough,15,21,-7,19,26
2016,24,Leicester,16,21,-14,24,38
2016,24,Swansea,17,21,-24,28,52
2016,24,Crystal Palace,18,19,-9,32,41
2016,24,Hull City,19,17,-27,20,47
2016,24,Sunderland,20,16,-22,20,42
2016,25,Chelsea,1,59,34,51,17
2016,25,Spurs,2,50,30,46,16
2016,25,Man City,3,49,20,49,29
2016,25,Arsenal,4,47,24,52,28
2016,25,Liverpool,5,46,22,52,30
2016,25,Man Utd,6,45,15,36,21
2016,25,Everton,7,40,13,40,27
2016,25,West Brom,8,36,3,32,29
2016,25,West Ham,9,31,-9,32,41
2016,25,Watford,10,30,-11,29,40
2016,25,Stoke City,11,29,-7,29,36
2016,25,Burnley,12,29,-9,26,35
2016,25,Southampton,13,27,-7,24,31
2016,25,Bournemouth,14,26,-12,35,47
2016,25,Middlesbrough,15,21,-8,19,27
2016,25,Leicester,16,21,-17,24,41
2016,25,Swansea,17,21,-25,29,54
2016,25,Hull City,18,20,-25,22,47
2016,25,Crystal Palace,19,19,-13,32,45
2016,25,Sunderland,20,19,-18,24,42
2016,26,Chelsea,1,60,34,52,18
2016,26,Man City,2,52,22,51,29
2016,26,Spurs,3,50,28,46,18
2016,26,Arsenal,4,50,26,54,28
2016,26,Liverpool,5,49,24,54,30
2016,26,Man Utd,6,48,17,38,21
2016,26,Everton,7,41,13,40,27
2016,26,West Brom,8,37,3,34,31
2016,26,Stoke City,9,32,-6,30,36
2016,26,West Ham,10,32,-9,34,43
2016,26,Southampton,11,30,-3,28,31
2016,26,Burnley,12,30,-9,27,36
2016,26,Watford,13,30,-13,29,42
2016,26,Bournemouth,14,26,-14,35,49
2016,26,Swansea,15,24,-23,31,54
2016,26,Middlesbrough,16,22,-8,19,27
2016,26,Leicester,17,21,-19,24,43
2016,26,Hull City,18,20,-27,22,49
2016,26,Crystal Palace,19,19,-14,32,46
2016,26,Sunderland,20,19,-22,24,46
2016,27,Chelsea,1,63,36,55,19
2016,27,Spurs,2,53,32,50,18
2016,27,Arsenal,3,53,28,56,28
2016,27,Man City,4,53,22,51,29
2016,27,Liverpool,5,49,22,55,33
2016,27,Man Utd,6,49,17,38,21
2016,27,Everton,7,44,15,42,27
2016,27,West Brom,8,40,4,36,32
2016,27,West Ham,9,33,-9,35,44
2016,27,Stoke City,10,32,-10,30,40
2016,27,Burnley,11,31,-9,28,37
2016,27,Watford,12,31,-13,30,43
2016,27,Southampton,13,30,-5,28,33
2016,27,Bournemouth,14,26,-15,36,51
2016,27,Leicester,15,24,-17,27,44
2016,27,Swansea,16,24,-25,32,57
2016,27,Middlesbrough,17,22,-9,19,28
2016,27,Crystal Palace,18,22,-13,33,46
2016,27,Hull City,19,21,-27,23,50
2016,27,Sunderland,20,19,-24,24,48
2016,28,Chelsea,1,66,37,57,20
2016,28,Spurs,2,56,33,53,20
2016,28,Man City,3,56,24,53,29
2016,28,Arsenal,4,53,26,57,31
2016,28,Liverpool,5,52,24,58,34
2016,28,Man Utd,6,50,17,39,22
2016,28,Everton,7,44,14,44,30
2016,28,West Brom,8,40,2,36,34
2016,28,Stoke City,9,35,-8,32,40
2016,28,Southampton,10,33,-4,32,36
2016,28,West Ham,11,33,-10,36,46
2016,28,Burnley,12,31,-10,30,40
2016,28,Watford,13,31,-14,33,47
2016,28,Bournemouth,14,27,-15,37,52
2016,28,Leicester,15,27,-15,30,45
2016,28,Swansea,16,27,-24,35,59
2016,28,Crystal Palace,17,25,-11,35,46
2016,28,Middlesbrough,18,22,-11,19,30
2016,28,Hull City,19,21,-29,24,53
2016,28,Sunderland,20,19,-26,24,50
2016,29,Chelsea,1,69,38,61,23
2016,29,Spurs,2,59,34,54,20
2016,29,Man City,3,57,24,53,29
2016,29,Arsenal,4,56,27,58,31
2016,29,Liverpool,5,55,25,60,35
2016,29,Man Utd,6,51,17,39,22
2016,29,Everton,7,47,17,47,30
2016,29,West Brom,8,40,-1,36,37
2016,29,Stoke City,9,36,-8,32,40
2016,29,Southampton,10,34,-4,32,36
2016,29,West Ham,11,33,-11,38,49
2016,29,Burnley,12,31,-11,31,42
2016,29,Watford,13,31,-15,36,51
2016,29,Bournemouth,14,30,-14,40,54
2016,29,Leicester,15,27,-16,30,46
2016,29,Swansea,16,27,-25,36,61
2016,29,Middlesbrough,17,25,-10,20,30
2016,29,Crystal Palace,18,25,-12,35,47
2016,29,Hull City,19,24,-28,26,54
2016,29,Sunderland,20,19,-27,24,51
2016,30,Chelsea,1,72,39,63,24
2016,30,Spurs,2,62,35,56,21
2016,30,Man City,3,58,24,54,30
2016,30,Liverpool,4,56,25,61,36
2016,30,Arsenal,5,56,25,59,34
2016,30,Man Utd,6,54,19,42,23
2016,30,Everton,7,50,21,51,30
2016,30,West Brom,8,43,1,39,38
2016,30,Stoke City,9,36,-9,33,42
2016,30,Southampton,10,34,-5,33,38
2016,30,Bournemouth,11,33,-12,42,54
2016,30,West Ham,12,33,-12,40,52
2016,30,Burnley,13,32,-11,31,42
2016,30,Watford,14,31,-16,36,52
2016,30,Leicester,15,30,-15,33,48
2016,30,Crystal Palace,16,28,-11,36,47
2016,30,Swansea,17,27,-27,36,63
2016,30,Middlesbrough,18,25,-12,21,33
2016,30,Hull City,19,24,-32,26,58
2016,30,Sunderland,20,20,-27,24,51
2016,31,Chelsea,1,72,38,64,26
2016,31,Spurs,2,65,37,58,21
2016,31,Liverpool,3,59,27,64,37
2016,31,Man City,4,59,24,56,32
2016,31,Arsenal,5,57,25,61,36
2016,31,Man Utd,6,55,19,42,23
2016,31,Everton,7,50,19,52,33
2016,31,West Brom,8,44,1,39,38
2016,31,Stoke City,9,36,-11,33,44
2016,31,Southampton,10,35,-5,33,38
2016,31,Bournemouth,11,34,-12,42,54
2016,31,Watford,12,34,-15,37,52
2016,31,West Ham,13,33,-13,41,54
2016,31,Leicester,14,33,-13,35,48
2016,31,Burnley,15,32,-13,31,44
2016,31,Crystal Palace,16,31,-10,38,48
2016,31,Swansea,17,28,-27,36,63
2016,31,Hull City,18,27,-31,28,59
2016,31,Middlesbrough,19,26,-12,21,33
2016,31,Sunderland,20,20,-28,24,52
2016,32,Chelsea,1,75,39,66,27
2016,32,Spurs,2,68,39,61,22
2016,32,Arsenal,3,60,28,64,36
2016,32,Liverpool,4,60,27,66,39
2016,32,Man City,5,59,23,57,34
2016,32,Man Utd,6,56,19,43,24
2016,32,Everton,7,51,19,53,34
2016,32,West Brom,8,44,-1,39,40
2016,32,Southampton,9,38,-3,36,39
2016,32,Watford,10,37,-13,39,52
2016,32,Leicester,11,36,-11,37,48
2016,32,Stoke City,12,36,-12,33,45
2016,32,Bournemouth,13,35,-12,44,56
2016,32,Burnley,14,35,-12,32,44
2016,32,West Ham,15,33,-16,41,57
2016,32,Crystal Palace,16,31,-12,39,51
2016,32,Hull City,17,30,-29,32,61
2016,32,Swansea,18,28,-29,37,66
2016,32,Middlesbrough,19,26,-14,23,37
2016,32,Sunderland,20,20,-30,24,54
2016,33,Chelsea,1,78,41,69,28
2016,33,Spurs,2,71,43,65,22
2016,33,Liverpool,3,63,28,68,40
2016,33,Man City,4,62,25,60,35
2016,33,Arsenal,5,60,25,64,39
2016,33,Man Utd,6,59,22,46,24
2016,33,Everton,7,54,21,57,36
2016,33,West Brom,8,44,-2,39,41
2016,33,Southampton,9,41,-2,37,39
2016,33,Watford,10,37,-17,39,56
2016,33,Burnley,11,36,-12,32,44
2016,33,Leicester,12,36,-13,39,52
2016,33,Stoke City,13,36,-13,34,47
2016,33,West Ham,14,36,-15,42,57
2016,33,Bournemouth,15,35,-14,45,59
2016,33,Crystal Palace,16,34,-9,42,51
2016,33,Hull City,17,30,-31,33,64
2016,33,Swansea,18,28,-30,37,67
2016,33,Middlesbrough,19,27,-14,23,37
2016,33,Sunderland,20,20,-33,24,57
2016,34,Chelsea,1,78,39,69,30
2016,34,Spurs,2,74,47,69,22
2016,34,Liverpool,3,66,29,69,40
2016,34,Man City,4,65,28,63,35
2016,34,Arsenal,5,63,26,66,40
2016,34,Man Utd,6,62,24,48,24
2016,34,Everton,7,57,23,60,37
2016,34,West Brom,8,44,-3,39,42
2016,34,Southampton,9,41,-5,37,42
2016,34,Watford,10,40,-16,40,56
2016,34,Stoke City,11,39,-11,37,48
2016,34,Leicester,12,37,-13,41,54
2016,34,West Ham,13,37,-15,44,59
2016,34,Burnley,14,36,-14,33,47
2016,34,Crystal Palace,15,35,-9,44,53
2016,34,Bournemouth,16,35,-18,45,63
2016,34,Hull City,17,30,-33,34,67
2016,34,Swansea,18,28,-31,37,68
2016,34,Middlesbrough,19,27,-15,24,39
2016,34,Sunderland,20,21,-33,26,59
2016,35,Chelsea,1,81,41,73,32
2016,35,Spurs,2,77,52,75,23
2016,35,Man City,3,68,30,66,36
2016,35,Liverpool,4,66,28,70,42
2016,35,Arsenal,5,66,28,68,40
2016,35,Man Utd,6,65,26,50,24
2016,35,Everton,7,58,23,60,37
2016,35,West Brom,8,44,-5,40,45
2016,35,Southampton,9,41,-7,39,46
2016,35,Watford,10,40,-18,40,58
2016,35,Stoke City,11,39,-13,37,50
2016,35,Crystal Palace,12,38,-8,46,54
2016,35,Bournemouth,13,38,-14,49,63
2016,35,West Ham,14,38,-15,44,59
2016,35,Leicester,15,37,-18,42,60
2016,35,Burnley,16,36,-16,33,49
2016,35,Hull City,17,33,-31,36,67
2016,35,Swansea,18,31,-29,39,68
2016,35,Middlesbrough,19,27,-19,24,43
2016,35,Sunderland,20,21,-35,26,61
2016,36,Chelsea,1,84,44,76,32
2016,36,Spurs,2,80,54,77,23
2016,36,Man City,3,69,30,68,38
2016,36,Liverpool,4,69,29,71,42
2016,36,Arsenal,5,66,26,68,42
2016,36,Man Utd,6,66,26,51,25
2016,36,Everton,7,58,20,60,40
2016,36,West Brom,8,44,-6,40,46
2016,36,Southampton,9,42,-7,39,46
2016,36,Bournemouth,10,41,-13,50,63
2016,36,Stoke City,11,40,-13,37,50
2016,36,Leicester,12,40,-17,43,60
2016,36,Watford,13,40,-19,40,59
2016,36,Burnley,14,39,-14,35,49
2016,36,West Ham,15,39,-15,44,59
2016,36,Crystal Palace,16,38,-10,46,56
2016,36,Hull City,17,34,-31,36,67
2016,36,Swansea,18,32,-29,40,69
2016,36,Middlesbrough,19,28,-19,26,45
2016,36,Sunderland,20,21,-36,26,62
2016,37,Chelsea,1,87,47,79,32
2016,37,Spurs,2,80,53,77,24
2016,37,Man City,3,72,35,73,38
2016,37,Liverpool,4,70,29,71,42
2016,37,Arsenal,5,69,28,70,42
2016,37,Man Utd,6,66,24,51,27
2016,37,Everton,7,58,19,60,41
2016,37,West Brom,8,45,-6,42,48
2016,37,Southampton,9,43,-7,39,46
2016,37,Leicester,10,43,-14,46,60
2016,37,Bournemouth,11,42,-13,52,65
2016,37,West Ham,12,42,-14,45,59
2016,37,Stoke City,13,41,-13,39,52
2016,37,Burnley,14,40,-14,37,51
2016,37,Watford,15,40,-22,40,62
2016,37,Crystal Palace,16,38,-15,46,61
2016,37,Swansea,17,35,-28,41,69
2016,37,Hull City,18,34,-33,36,69
2016,37,Middlesbrough,19,28,-22,26,48
2016,37,Sunderland,20,24,-34,28,62
2016,38,Chelsea,1,90,48,80,32
2016,38,Spurs,2,83,54,79,25
2016,38,Man City,3,75,36,75,39
2016,38,Liverpool,4,73,33,75,42
2016,38,Arsenal,5,72,31,74,43
2016,38,Man Utd,6,66,23,52,29
2016,38,Everton,7,61,20,61,41
2016,38,Southampton,8,46,-6,41,47
2016,38,West Brom,9,45,-7,42,49
2016,38,Bournemouth,10,45,-12,54,66
2016,38,Leicester,11,43,-15,47,62
2016,38,West Ham,12,42,-18,45,63
2016,38,Crystal Palace,13,41,-11,50,61
2016,38,Stoke City,14,41,-16,40,56
2016,38,Burnley,15,40,-15,38,53
2016,38,Watford,16,40,-23,40,63
2016,38,Swansea,17,38,-26,43,69
2016,38,Hull City,18,34,-37,36,73
2016,38,Middlesbrough,19,28,-23,27,50
2016,38,Sunderland,20,24,-36,28,64
2016,39,Chelsea,1,93,52,85,33
2016,39,Spurs,2,86,60,86,26
2016,39,Man City,3,78,41,80,39
2016,39,Liverpool,4,76,36,78,42
2016,39,Arsenal,5,75,33,77,44
2016,39,Man Utd,6,69,25,54,29
2016,39,Everton,7,61,18,62,44
2016,39,Southampton,8,46,-7,41,48
2016,39,Bournemouth,9,46,-12,55,67
2016,39,West Brom,10,45,-8,43,51
2016,39,West Ham,11,45,-17,47,64
2016,39,Leicester,12,44,-15,48,63
2016,39,Stoke City,13,44,-15,41,56
2016,39,Crystal Palace,14,41,-13,50,63
2016,39,Swansea,15,41,-25,45,70
2016,39,Burnley,16,40,-16,39,55
2016,39,Watford,17,40,-28,40,68
2016,39,Hull City,18,34,-43,37,80
2016,39,Middlesbrough,19,28,-26,27,53
2016,39,Sunderland,20,24,-40,29,69
2017,2,Man Utd,1,3,4,4,0
2017,2,Huddersfield,2,3,3,3,0
2017,2,Spurs,3,3,2,2,0
2017,2,Man City,4,3,2,2,0
2017,2,Arsenal,5,3,1,4,3
2017,2,Burnley,6,3,1,3,2
2017,2,Everton,7,3,1,1,0
2017,2,West Brom,8,3,1,1,0
2017,2,Liverpool,9,1,0,3,3
2017,2,Watford,10,1,0,3,3
2017,2,Southampton,11,1,0,0,0
2017,2,Swansea,12,1,0,0,0
2017,2,Leicester,13,0,-1,3,4
2017,2,Chelsea,14,0,-1,2,3
2017,2,Bournemouth,15,0,-1,0,1
2017,2,Stoke City,16,0,-1,0,1
2017,2,Newcastle,17,0,-2,0,2
2017,2,Brighton,18,0,-2,0,2
2017,2,Crystal Palace,19,0,-3,0,3
2017,2,West Ham,20,0,-4,0,4
2017,3,Man Utd,1,6,8,8,0
2017,3,Huddersfield,2,6,4,4,0
2017,3,West Brom,3,6,2,2,0
2017,3,Watford,4,4,2,5,3
2017,3,Man City,5,4,2,3,1
2017,3,Liverpool,6,4,1,4,3
2017,3,Southampton,7,4,1,3,2
2017,3,Everton,8,4,1,2,1
2017,3,Leicester,9,3,1,5,4
2017,3,Spurs,10,3,1,3,2
2017,3,Chelsea,11,3,0,4,4
2017,3,Arsenal,12,3,0,4,4
2017,3,Burnley,13,3,0,3,3
2017,3,Stoke City,14,3,0,1,1
2017,3,Swansea,15,1,-4,0,4
2017,3,Bournemouth,16,0,-3,0,3
2017,3,Newcastle,17,0,-3,0,3
2017,3,Crystal Palace,18,0,-4,0,4
2017,3,Brighton,19,0,-4,0,4
2017,3,West Ham,20,0,-5,2,7
2017,4,Man Utd,1,9,10,10,0
2017,4,Liverpool,2,7,5,8,3
2017,4,Huddersfield,3,7,4,4,0
2017,4,Man City,4,7,3,5,2
2017,4,West Brom,5,7,2,3,1
2017,4,Chelsea,6,6,2,6,4
2017,4,Watford,7,5,2,5,3
2017,4,Southampton,8,5,1,3,2
2017,4,Spurs,9,4,1,4,3
2017,4,Burnley,10,4,0,4,4
2017,4,Stoke City,11,4,0,2,2
2017,4,Everton,12,4,-1,2,3
2017,4,Swansea,13,4,-2,2,4
2017,4,Newcastle,14,3,0,3,3
2017,4,Leicester,15,3,-1,5,6
2017,4,Arsenal,16,3,-4,4,8
2017,4,Brighton,17,1,-4,0,4
2017,4,Bournemouth,18,0,-4,1,5
2017,4,Crystal Palace,19,0,-6,0,6
2017,4,West Ham,20,0,-8,2,10
2017,5,Man Utd,1,10,10,12,2
2017,5,Man City,2,10,8,10,2
2017,5,Chelsea,3,9,3,8,5
2017,5,Watford,4,8,4,7,3
2017,5,Spurs,5,7,4,7,3
2017,5,Huddersfield,6,7,2,4,2
2017,5,Burnley,7,7,1,5,4
2017,5,Liverpool,8,7,0,8,8
2017,5,West Brom,9,7,0,4,4
2017,5,Newcastle,10,6,1,4,3
2017,5,Arsenal,11,6,-1,7,8
2017,5,Stoke City,12,5,0,4,4
2017,5,Southampton,13,5,-1,3,4
2017,5,Brighton,14,4,-2,3,5
2017,5,Swansea,15,4,-3,2,5
2017,5,Everton,16,4,-4,2,6
2017,5,Leicester,17,3,-2,6,8
2017,5,West Ham,18,3,-6,4,10
2017,5,Bournemouth,19,0,-7,1,8
2017,5,Crystal Palace,20,0,-7,0,7
2017,6,Man City,1,13,14,16,2
2017,6,Man Utd,2,13,14,16,2
2017,6,Chelsea,3,10,3,8,5
2017,6,Newcastle,4,9,2,6,4
2017,6,Spurs,5,8,4,7,3
2017,6,Huddersfield,6,8,2,5,3
2017,6,Burnley,7,8,1,6,5
2017,6,Liverpool,8,8,0,9,9
2017,6,Southampton,9,8,0,4,4
2017,6,West Brom,10,8,0,4,4
2017,6,Watford,11,8,-2,7,9
2017,6,Arsenal,12,7,-1,7,8
2017,6,Stoke City,13,5,-1,5,6
2017,6,Swansea,14,5,-3,2,5
2017,6,Leicester,15,4,-2,7,9
2017,6,Brighton,16,4,-3,4,7
2017,6,West Ham,17,4,-6,4,10
2017,6,Everton,18,4,-8,2,10
2017,6,Bournemouth,19,3,-6,3,9
2017,6,Crystal Palace,20,0,-8,0,8
2017,7,Man City,1,16,19,21,2
2017,7,Man Utd,2,16,15,17,2
2017,7,Chelsea,3,13,7,12,5
2017,7,Spurs,4,11,5,10,5
2017,7,Liverpool,5,11,1,12,11
2017,7,Watford,6,11,-1,9,10
2017,7,Arsenal,7,10,1,9,8
2017,7,Huddersfield,8,9,2,5,3
2017,7,Burnley,9,9,1,6,5
2017,7,Newcastle,10,9,1,6,5
2017,7,Southampton,11,8,-1,4,5
2017,7,West Brom,12,8,-2,4,6
2017,7,Brighton,13,7,-2,5,7
2017,7,Everton,14,7,-7,4,11
2017,7,Swansea,15,5,-4,3,7
2017,7,Stoke City,16,5,-5,5,10
2017,7,Leicester,17,4,-3,9,12
2017,7,West Ham,18,4,-7,6,13
2017,7,Bournemouth,19,3,-7,4,11
2017,7,Crystal Palace,20,0,-13,0,13
2017,8,Man City,1,19,20,22,2
2017,8,Man Utd,2,19,19,21,2
2017,8,Spurs,3,14,9,14,5
2017,8,Chelsea,4,13,6,12,6
2017,8,Arsenal,5,13,3,11,8
2017,8,Burnley,6,12,2,7,5
2017,8,Liverpool,7,12,1,13,12
2017,8,Watford,8,12,-1,11,12
2017,8,Newcastle,9,10,1,7,6
2017,8,West Brom,10,9,-2,6,8
2017,8,Huddersfield,11,9,-2,5,7
2017,8,Southampton,12,8,-2,5,7
2017,8,Stoke City,13,8,-4,7,11
2017,8,Brighton,14,7,-4,5,9
2017,8,West Ham,15,7,-6,7,13
2017,8,Everton,16,7,-8,4,12
2017,8,Leicester,17,5,-3,9,12
2017,8,Swansea,18,5,-5,3,8
2017,8,Bournemouth,19,4,-7,4,11
2017,8,Crystal Palace,20,0,-17,0,17
2017,9,Man City,1,22,25,29,4
2017,9,Man Utd,2,20,19,21,2
2017,9,Spurs,3,17,10,15,5
2017,9,Watford,4,15,0,13,13
2017,9,Chelsea,5,13,5,13,8
2017,9,Arsenal,6,13,2,12,10
2017,9,Burnley,7,13,2,8,6
2017,9,Liverpool,8,13,1,13,12
2017,9,Newcastle,9,11,1,9,8
2017,9,West Brom,10,10,-2,7,9
2017,9,Southampton,11,9,-2,7,9
2017,9,Huddersfield,12,9,-4,5,9
2017,9,Swansea,13,8,-3,5,8
2017,9,Brighton,14,8,-4,6,10
2017,9,West Ham,15,8,-6,8,14
2017,9,Everton,16,8,-8,5,13
2017,9,Stoke City,17,8,-9,9,18
2017,9,Leicester,18,6,-3,10,13
2017,9,Bournemouth,19,4,-8,4,12
2017,9,Crystal Palace,20,3,-16,2,18
2017,10,Man City,1,25,28,32,4
2017,10,Man Utd,2,20,18,22,4
2017,10,Spurs,3,20,13,19,6
2017,10,Chelsea,4,16,7,17,10
2017,10,Arsenal,5,16,5,17,12
2017,10,Watford,6,15,-2,15,17
2017,10,Newcastle,7,14,2,10,8
2017,10,Burnley,8,13,-1,8,9
2017,10,Liverpool,9,13,-2,14,16
2017,10,Southampton,10,12,-1,8,9
2017,10,Huddersfield,11,12,-3,7,10
2017,10,Brighton,12,11,-1,9,10
2017,10,West Brom,13,10,-3,7,10
2017,10,Leicester,14,9,-2,12,14
2017,10,Swansea,15,8,-4,6,10
2017,10,West Ham,16,8,-9,8,17
2017,10,Stoke City,17,8,-10,10,20
2017,10,Everton,18,8,-11,7,18
2017,10,Bournemouth,19,7,-7,6,13
2017,10,Crystal Palace,20,3,-17,2,19
2017,11,Man City,1,28,29,35,6
2017,11,Man Utd,2,23,19,23,4
2017,11,Spurs,3,20,12,19,7
2017,11,Chelsea,4,19,8,18,10
2017,11,Arsenal,5,19,6,19,13
2017,11,Liverpool,6,16,1,17,16
2017,11,Burnley,7,16,0,9,9
2017,11,Watford,8,15,-3,15,18
2017,11,Newcastle,9,14,1,10,9
2017,11,Southampton,10,13,-1,9,10
2017,11,Leicester,11,12,0,14,14
2017,11,Brighton,12,12,-1,10,11
2017,11,Huddersfield,13,12,-6,7,13
2017,11,Stoke City,14,11,-9,11,20
2017,11,West Brom,15,10,-4,9,13
2017,11,West Ham,16,9,-9,10,19
2017,11,Swansea,17,8,-5,7,12
2017,11,Everton,18,8,-13,7,20
2017,11,Bournemouth,19,7,-8,6,14
2017,11,Crystal Palace,20,4,-17,4,21
2017,12,Man City,1,31,31,38,7
2017,12,Man Utd,2,23,18,23,5
2017,12,Spurs,3,23,13,20,7
2017,12,Chelsea,4,22,9,19,10
2017,12,Liverpool,5,19,4,21,17
2017,12,Arsenal,6,19,4,20,16
2017,12,Burnley,7,19,1,10,9
2017,12,Brighton,8,15,0,11,11
2017,12,Watford,9,15,-4,17,21
2017,12,Huddersfield,10,15,-5,8,13
2017,12,Newcastle,11,14,0,10,10
2017,12,Leicester,12,13,0,16,16
2017,12,Southampton,13,13,-2,9,11
2017,12,Stoke City,14,12,-9,13,22
2017,12,Everton,15,11,-12,10,22
2017,12,West Brom,16,10,-5,9,14
2017,12,Bournemouth,17,10,-7,7,14
2017,12,West Ham,18,9,-12,11,23
2017,12,Swansea,19,8,-6,7,13
2017,12,Crystal Palace,20,4,-18,4,22
2017,13,Man City,1,34,33,40,7
2017,13,Man Utd,2,26,21,27,6
2017,13,Chelsea,3,25,13,23,10
2017,13,Spurs,4,23,11,20,9
2017,13,Liverpool,5,22,7,24,17
2017,13,Arsenal,6,22,6,22,16
2017,13,Burnley,7,22,3,12,9
2017,13,Watford,8,18,-2,19,21
2017,13,Brighton,9,16,0,13,13
2017,13,Huddersfield,10,15,-9,8,17
2017,13,Newcastle,11,14,-3,11,14
2017,13,Leicester,12,13,-2,16,18
2017,13,Bournemouth,13,13,-3,11,14
2017,13,Southampton,14,13,-5,9,14
2017,13,Stoke City,15,13,-9,15,24
2017,13,Everton,16,12,-12,12,24
2017,13,West Brom,17,10,-9,9,18
2017,13,West Ham,18,9,-14,11,25
2017,13,Swansea,19,8,-8,7,15
2017,13,Crystal Palace,20,5,-18,6,24
2017,14,Man City,1,37,34,42,8
2017,14,Man Utd,2,29,22,28,6
2017,14,Chelsea,3,26,13,24,11
2017,14,Arsenal,4,25,7,23,16
2017,14,Spurs,5,24,11,21,10
2017,14,Liverpool,6,23,7,25,18
2017,14,Burnley,7,22,2,12,10
2017,14,Watford,8,21,1,22,21
2017,14,Brighton,9,16,-1,13,14
2017,14,Southampton,10,16,-2,13,15
2017,14,Huddersfield,11,15,-10,9,19
2017,14,Leicester,12,14,-2,17,19
2017,14,Bournemouth,13,14,-3,11,14
2017,14,Newcastle,14,14,-6,11,17
2017,14,Stoke City,15,13,-10,16,26
2017,14,Everton,16,12,-15,13,28
2017,14,West Brom,17,11,-9,10,19
2017,14,West Ham,18,10,-14,12,26
2017,14,Swansea,19,9,-8,7,15
2017,14,Crystal Palace,20,8,-17,8,25
2017,15,Man City,1,40,35,44,9
2017,15,Man Utd,2,32,24,32,8
2017,15,Chelsea,3,29,14,25,11
2017,15,Arsenal,4,28,12,28,16
2017,15,Liverpool,5,26,10,28,18
2017,15,Burnley,6,25,3,14,11
2017,15,Spurs,7,24,10,22,12
2017,15,Watford,8,21,-1,24,25
2017,15,Leicester,9,17,-1,19,20
2017,15,Brighton,10,17,-1,13,14
2017,15,Southampton,11,16,-3,14,17
2017,15,Newcastle,12,15,-6,13,19
2017,15,Everton,13,15,-11,17,28
2017,15,Huddersfield,14,15,-15,9,24
2017,15,Bournemouth,15,14,-4,12,16
2017,15,Stoke City,16,13,-13,16,29
2017,15,West Brom,17,12,-9,12,21
2017,15,West Ham,18,10,-18,12,30
2017,15,Swansea,19,9,-9,7,16
2017,15,Crystal Palace,20,9,-17,8,25
2017,16,Man City,1,43,36,46,10
2017,16,Man Utd,2,35,26,35,9
2017,16,Chelsea,3,32,16,28,12
2017,16,Liverpool,4,29,14,33,19
2017,16,Arsenal,5,28,10,29,19
2017,16,Spurs,6,25,10,23,13
2017,16,Burnley,7,25,2,14,12
2017,16,Watford,8,22,-1,25,26
2017,16,Leicester,9,20,0,20,20
2017,16,Everton,10,18,-9,19,28
2017,16,Southampton,11,17,-3,15,18
2017,16,Brighton,12,17,-5,14,19
2017,16,Stoke City,13,16,-12,18,30
2017,16,Bournemouth,14,15,-4,13,17
2017,16,Newcastle,15,15,-8,14,22
2017,16,Huddersfield,16,15,-17,9,26
2017,16,West Brom,17,13,-9,12,21
2017,16,Crystal Palace,18,10,-17,8,25
2017,16,West Ham,19,10,-19,13,32
2017,16,Swansea,20,9,-10,8,18
2017,17,Man City,1,46,37,48,11
2017,17,Man Utd,2,35,25,36,11
2017,17,Chelsea,3,32,15,28,13
2017,17,Liverpool,4,30,14,34,20
2017,17,Arsenal,5,29,10,30,20
2017,17,Spurs,6,28,14,28,14
2017,17,Burnley,7,28,3,15,12
2017,17,Leicester,8,23,1,23,22
2017,17,Watford,9,22,-2,25,27
2017,17,Everton,10,19,-9,20,29
2017,17,Southampton,11,18,-3,16,19
2017,17,Huddersfield,12,18,-15,11,26
2017,17,Brighton,13,17,-7,14,21
2017,17,Bournemouth,14,16,-4,15,19
2017,17,Stoke City,15,16,-16,19,35
2017,17,Newcastle,16,15,-9,16,25
2017,17,West Brom,17,13,-10,12,22
2017,17,West Ham,18,13,-18,14,32
2017,17,Swansea,19,12,-9,9,18
2017,17,Crystal Palace,20,11,-17,10,27
2017,18,Man City,1,49,41,52,11
2017,18,Man Utd,2,38,26,37,11
2017,18,Chelsea,3,35,17,31,14
2017,18,Spurs,4,31,16,30,14
2017,18,Liverpool,5,31,14,34,20
2017,18,Burnley,6,31,4,16,12
2017,18,Arsenal,7,30,10,30,20
2017,18,Leicester,8,26,4,27,23
2017,18,Watford,9,22,-3,26,29
2017,18,Everton,10,22,-8,21,29
2017,18,Southampton,11,18,-6,17,23
2017,18,Huddersfield,12,18,-17,12,29
2017,18,Brighton,13,17,-9,14,23
2017,18,Bournemouth,14,16,-5,15,20
2017,18,Stoke City,15,16,-17,19,36
2017,18,Newcastle,16,15,-10,16,26
2017,18,West Brom,17,14,-10,12,22
2017,18,Crystal Palace,18,14,-16,12,28
2017,18,West Ham,19,14,-18,14,32
2017,18,Swansea,20,12,-13,9,22
2017,19,Man City,1,52,44,56,12
2017,19,Man Utd,2,41,27,39,12
2017,19,Chelsea,3,38,18,32,14
2017,19,Liverpool,4,34,18,38,20
2017,19,Arsenal,5,33,11,31,20
2017,19,Burnley,6,32,4,16,12
2017,19,Spurs,7,31,13,31,18
2017,19,Leicester,8,26,1,27,26
2017,19,Everton,9,25,-6,24,30
2017,19,Watford,10,22,-6,27,33
2017,19,Huddersfield,11,21,-14,16,30
2017,19,Southampton,12,18,-7,17,24
2017,19,Brighton,13,18,-9,14,23
2017,19,Crystal Palace,14,17,-13,15,28
2017,19,West Ham,15,17,-15,17,32
2017,19,Bournemouth,16,16,-9,15,24
2017,19,Stoke City,17,16,-20,19,39
2017,19,Newcastle,18,15,-11,16,27
2017,19,West Brom,19,14,-11,13,24
2017,19,Swansea,20,12,-15,10,25
2017,20,Man City,1,55,48,60,12
2017,20,Man Utd,2,42,27,41,14
2017,20,Chelsea,3,39,18,32,14
2017,20,Liverpool,4,35,18,41,23
2017,20,Spurs,5,34,16,34,18
2017,20,Arsenal,6,34,11,34,23
2017,20,Burnley,7,32,1,16,15
2017,20,Leicester,8,27,1,29,28
2017,20,Everton,9,26,-6,24,30
2017,20,Watford,10,22,-7,27,34
2017,20,Huddersfield,11,22,-14,17,31
2017,20,Brighton,12,21,-8,15,23
2017,20,Southampton,13,19,-7,18,25
2017,20,Stoke City,14,19,-18,22,40
2017,20,Newcastle,15,18,-10,19,29
2017,20,Crystal Palace,16,18,-13,16,29
2017,20,West Ham,17,17,-16,19,35
2017,20,Bournemouth,18,16,-13,15,28
2017,20,West Brom,19,14,-13,14,27
2017,20,Swansea,20,13,-15,11,26
2017,21,Man City,1,58,49,61,12
2017,21,Man Utd,2,43,27,43,16
2017,21,Chelsea,3,42,20,34,14
2017,21,Liverpool,4,38,23,46,23
2017,21,Spurs,5,37,19,39,20
2017,21,Arsenal,6,37,12,37,25
2017,21,Burnley,7,33,1,18,17
2017,21,Leicester,8,27,0,30,30
2017,21,Everton,9,27,-6,24,30
2017,21,Watford,10,25,-6,29,35
2017,21,Huddersfield,11,23,-14,18,32
2017,21,Brighton,12,21,-10,15,25
2017,21,Stoke City,13,20,-18,23,41
2017,21,Southampton,14,19,-10,20,30
2017,21,Newcastle,15,18,-11,19,30
2017,21,Crystal Palace,16,18,-14,18,32
2017,21,West Ham,17,18,-16,22,38
2017,21,Bournemouth,18,17,-13,18,31
2017,21,West Brom,19,15,-13,14,27
2017,21,Swansea,20,13,-20,11,31
2017,22,Man City,1,59,49,61,12
2017,22,Chelsea,2,45,25,39,14
2017,22,Man Utd,3,44,27,43,16
2017,22,Liverpool,4,41,24,48,24
2017,22,Spurs,5,38,19,40,21
2017,22,Arsenal,6,38,12,38,26
2017,22,Burnley,7,34,1,18,17
2017,22,Leicester,8,27,-1,31,32
2017,22,Everton,9,27,-7,25,32
2017,22,Watford,10,25,-7,30,37
2017,22,Huddersfield,11,24,-14,18,32
2017,22,Brighton,12,22,-10,15,25
2017,22,Southampton,13,20,-10,20,30
2017,22,Bournemouth,14,20,-12,20,32
2017,22,Stoke City,15,20,-23,23,46
2017,22,Newcastle,16,19,-11,19,30
2017,22,Crystal Palace,17,19,-14,18,32
2017,22,West Ham,18,19,-16,23,39
2017,22,West Brom,19,16,-13,15,28
2017,22,Swansea,20,16,-19,13,32
2017,23,Man City,1,62,51,64,13
2017,23,Man Utd,2,47,29,45,16
2017,23,Chelsea,3,46,25,41,16
2017,23,Liverpool,4,44,25,50,25
2017,23,Spurs,5,41,21,42,21
2017,23,Arsenal,6,39,12,40,28
2017,23,Burnley,7,34,0,19,19
2017,23,Leicester,8,30,2,34,32
2017,23,Everton,9,27,-9,25,34
2017,23,Watford,10,25,-9,31,40
2017,23,Huddersfield,11,24,-17,18,35
2017,23,Brighton,12,23,-10,17,27
2017,23,Newcastle,13,22,-10,20,30
2017,23,Crystal Palace,14,22,-13,20,33
2017,23,West Ham,15,22,-15,25,40
2017,23,Bournemouth,16,21,-12,22,34
2017,23,Southampton,17,20,-11,21,32
2017,23,Stoke City,18,20,-24,23,47
2017,23,West Brom,19,16,-14,16,30
2017,23,Swansea,20,16,-21,13,34
2017,24,Man City,1,62,50,67,17
2017,24,Man Utd,2,50,32,48,16
2017,24,Liverpool,3,47,26,54,28
2017,24,Chelsea,4,47,25,41,16
2017,24,Spurs,5,44,25,46,21
2017,24,Arsenal,6,39,11,41,30
2017,24,Burnley,7,34,-1,19,20
2017,24,Leicester,8,31,2,34,32
2017,24,Everton,9,27,-13,25,38
2017,24,Watford,10,26,-9,33,42
2017,24,West Ham,11,25,-12,29,41
2017,24,Crystal Palace,12,25,-12,21,33
2017,24,Bournemouth,13,24,-11,24,35
2017,24,Huddersfield,14,24,-20,19,39
2017,24,Newcastle,15,23,-10,21,31
2017,24,Brighton,16,23,-12,17,29
2017,24,Southampton,17,21,-11,23,34
2017,24,Stoke City,18,20,-27,23,50
2017,24,West Brom,19,19,-12,18,30
2017,24,Swansea,20,17,-21,14,35
2017,25,Man City,1,65,52,70,18
2017,25,Man Utd,2,53,33,49,16
2017,25,Chelsea,3,50,29,45,16
2017,25,Liverpool,4,47,25,54,29
2017,25,Spurs,5,45,25,47,22
2017,25,Arsenal,6,42,14,45,31
2017,25,Leicester,7,34,4,36,32
2017,25,Burnley,8,34,-2,19,21
2017,25,Everton,9,28,-13,26,39
2017,25,Watford,10,26,-11,33,44
2017,25,West Ham,11,26,-12,30,42
2017,25,Bournemouth,12,25,-11,25,36
2017,25,Crystal Palace,13,25,-15,22,37
2017,25,Huddersfield,14,24,-22,19,41
2017,25,Newcastle,15,23,-12,22,34
2017,25,Brighton,16,23,-16,17,33
2017,25,Stoke City,17,23,-25,25,50
2017,25,Southampton,18,22,-11,24,35
2017,25,West Brom,19,20,-12,19,31
2017,25,Swansea,20,20,-20,15,35
2017,26,Man City,1,68,55,73,18
2017,26,Man Utd,2,53,31,49,18
2017,26,Liverpool,3,50,28,57,29
2017,26,Chelsea,4,50,26,45,19
2017,26,Spurs,5,48,27,49,22
2017,26,Arsenal,6,42,12,46,34
2017,26,Burnley,7,35,-2,20,22
2017,26,Leicester,8,34,3,37,34
2017,26,Everton,9,31,-12,28,40
2017,26,Bournemouth,10,28,-8,28,36
2017,26,Watford,11,27,-11,33,44
2017,26,West Ham,12,27,-12,31,43
2017,26,Crystal Palace,13,26,-15,23,38
2017,26,Newcastle,14,24,-12,23,35
2017,26,Brighton,15,24,-16,18,34
2017,26,Stoke City,16,24,-25,25,50
2017,26,Huddersfield,17,24,-25,19,44
2017,26,Southampton,18,23,-11,25,36
2017,26,Swansea,19,23,-18,18,36
2017,26,West Brom,20,20,-15,19,34
2017,27,Man City,1,69,55,74,19
2017,27,Man Utd,2,56,33,51,18
2017,27,Liverpool,3,51,28,59,31
2017,27,Chelsea,4,50,23,46,23
2017,27,Spurs,5,49,27,51,24
2017,27,Arsenal,6,45,16,51,35
2017,27,Burnley,7,36,-2,21,23
2017,27,Leicester,8,35,3,38,35
2017,27,Bournemouth,9,31,-7,30,37
2017,27,Everton,10,31,-16,29,45
2017,27,Watford,11,30,-8,37,45
2017,27,West Ham,12,27,-14,32,46
2017,27,Brighton,13,27,-14,21,35
2017,27,Crystal Palace,14,27,-15,24,39
2017,27,Southampton,15,26,-10,28,38
2017,27,Newcastle,16,25,-12,24,36
2017,27,Swansea,17,24,-18,19,37
2017,27,Stoke City,18,24,-26,26,52
2017,27,Huddersfield,19,24,-27,19,46
2017,27,West Brom,20,20,-16,21,37
2017,28,Man City,1,72,59,79,20
2017,28,Man Utd,2,56,32,51,19
2017,28,Liverpool,3,54,30,61,31
2017,28,Chelsea,4,53,26,49,23
2017,28,Spurs,5,52,28,52,24
2017,28,Arsenal,6,45,15,51,36
2017,28,Burnley,7,36,-3,21,24
2017,28,Leicester,8,35,-1,39,40
2017,28,Everton,9,34,-14,32,46
2017,28,Bournemouth,10,31,-10,31,41
2017,28,Watford,11,30,-10,37,47
2017,28,West Ham,12,30,-12,34,46
2017,28,Newcastle,13,28,-11,25,36
2017,28,Brighton,14,28,-14,22,36
2017,28,Crystal Palace,15,27,-17,25,42
2017,28,Swansea,16,27,-17,20,37
2017,28,Huddersfield,17,27,-24,23,47
2017,28,Southampton,18,26,-12,28,40
2017,28,Stoke City,19,25,-26,27,53
2017,28,West Brom,20,20,-19,21,40
2017,29,Man City,1,75,62,82,20
2017,29,Man Utd,2,59,33,53,20
2017,29,Liverpool,3,57,33,65,32
2017,29,Spurs,4,55,29,53,24
2017,29,Chelsea,5,53,25,50,25
2017,29,Arsenal,6,45,12,51,39
2017,29,Burnley,7,37,-3,22,25
2017,29,Leicester,8,36,-1,40,41
2017,29,Everton,9,34,-15,32,47
2017,29,Watford,10,33,-9,38,47
2017,29,Bournemouth,11,32,-10,33,43
2017,29,Brighton,12,31,-11,26,37
2017,29,West Ham,13,30,-15,35,50
2017,29,Huddersfield,14,30,-23,25,48
2017,29,Newcastle,15,29,-11,27,38
2017,29,Southampton,16,27,-12,29,41
2017,29,Crystal Palace,17,27,-18,25,43
2017,29,Swansea,18,27,-20,21,41
2017,29,Stoke City,19,26,-26,28,54
2017,29,West Brom,20,20,-20,22,42
2017,30,Man City,1,78,63,83,20
2017,30,Man Utd,2,62,34,56,22
2017,30,Liverpool,3,60,35,67,32
2017,30,Spurs,4,58,31,55,24
2017,30,Chelsea,5,53,24,50,26
2017,30,Arsenal,6,45,11,52,41
2017,30,Burnley,7,40,-2,24,26
2017,30,Leicester,8,37,-1,41,42
2017,30,Watford,9,36,-8,39,47
2017,30,Brighton,10,34,-10,28,38
2017,30,Everton,11,34,-16,33,49
2017,30,Bournemouth,12,33,-10,34,44
2017,30,Swansea,13,30,-17,25,42
2017,30,West Ham,14,30,-18,36,54
2017,30,Huddersfield,15,30,-25,25,50
2017,30,Newcastle,16,29,-13,27,40
2017,30,Southampton,17,28,-12,29,41
2017,30,Crystal Palace,18,27,-19,27,46
2017,30,Stoke City,19,27,-26,28,54
2017,30,West Brom,20,20,-21,22,43
2017,31,Man City,1,81,65,85,20
2017,31,Man Utd,2,65,35,58,23
2017,31,Spurs,3,61,34,59,25
2017,31,Liverpool,4,60,34,68,34
2017,31,Chelsea,5,56,25,52,27
2017,31,Arsenal,6,48,14,55,41
2017,31,Burnley,7,43,1,27,26
2017,31,Leicester,8,40,2,45,43
2017,31,Everton,9,37,-14,35,49
2017,31,Watford,10,36,-11,39,50
2017,31,Brighton,11,34,-12,28,40
2017,31,Bournemouth,12,33,-13,35,48
2017,31,Newcastle,13,32,-10,30,40
2017,31,Swansea,14,31,-17,25,42
2017,31,Huddersfield,15,31,-25,25,50
2017,31,West Ham,16,30,-21,36,57
2017,31,Southampton,17,28,-15,29,44
2017,31,Crystal Palace,18,27,-20,28,48
2017,31,Stoke City,19,27,-28,28,56
2017,31,West Brom,20,20,-24,23,47
2017,32,Man City,1,84,67,88,21
2017,32,Man Utd,2,66,35,58,23
2017,32,Spurs,3,64,35,60,25
2017,32,Liverpool,4,63,39,73,34
2017,32,Chelsea,5,59,26,54,28
2017,32,Arsenal,6,48,12,56,44
2017,32,Leicester,7,43,4,48,44
2017,32,Burnley,8,43,0,28,28
2017,32,Everton,9,40,-13,37,50
2017,32,Bournemouth,10,36,-12,37,49
2017,32,Watford,11,36,-16,39,55
2017,32,Brighton,12,34,-14,29,43
2017,32,Newcastle,13,32,-11,30,41
2017,32,Southampton,14,31,-14,30,44
2017,32,Swansea,15,31,-18,25,43
2017,32,West Ham,16,31,-21,36,57
2017,32,Huddersfield,17,31,-27,25,52
2017,32,Crystal Palace,18,30,-18,30,48
2017,32,Stoke City,19,27,-29,29,58
2017,32,West Brom,20,20,-25,24,49
2017,33,Man City,1,87,69,91,22
2017,33,Man Utd,2,69,37,60,23
2017,33,Spurs,3,67,37,63,26
2017,33,Liverpool,4,66,40,75,35
2017,33,Chelsea,5,59,24,55,31
2017,33,Arsenal,6,51,15,59,44
2017,33,Leicester,7,46,6,50,44
2017,33,Burnley,8,46,1,30,29
2017,33,Everton,9,40,-15,38,53
2017,33,Bournemouth,10,37,-12,39,51
2017,33,Watford,11,37,-16,41,57
2017,33,Newcastle,12,35,-10,31,41
2017,33,Brighton,13,34,-16,29,45
2017,33,West Ham,14,34,-18,39,57
2017,33,Southampton,15,31,-17,30,47
2017,33,Swansea,16,31,-20,25,45
2017,33,Huddersfield,17,31,-28,25,53
2017,33,Crystal Palace,18,30,-19,31,50
2017,33,Stoke City,19,27,-32,29,61
2017,33,West Brom,20,20,-26,25,51
2017,34,Man City,1,87,68,93,25
2017,34,Man Utd,2,72,38,63,25
2017,34,Spurs,3,70,38,65,27
2017,34,Liverpool,4,67,40,75,35
2017,34,Chelsea,5,60,24,56,32
2017,34,Arsenal,6,54,16,62,46
2017,34,Burnley,7,49,2,32,30
2017,34,Leicester,8,46,5,51,46
2017,34,Everton,9,41,-15,38,53
2017,34,Newcastle,10,38,-9,33,42
2017,34,Bournemouth,11,38,-12,41,53
2017,34,Watford,12,37,-17,42,59
2017,34,Brighton,13,35,-16,30,46
2017,34,West Ham,14,35,-18,40,58
2017,34,Swansea,15,32,-20,26,46
2017,34,Huddersfield,16,32,-28,26,54
2017,34,Southampton,17,31,-18,32,50
2017,34,Crystal Palace,18,31,-19,33,52
2017,34,Stoke City,19,27,-33,30,63
2017,34,West Brom,20,21,-26,26,52
2017,35,Man City,1,90,70,96,26
2017,35,Man Utd,2,72,37,63,26
2017,35,Liverpool,3,70,43,78,35
2017,35,Spurs,4,70,36,66,30
2017,35,Chelsea,5,63,25,59,34
2017,35,Arsenal,6,54,15,63,48
2017,35,Burnley,7,52,3,34,31
2017,35,Leicester,8,46,4,52,48
2017,35,Everton,9,42,-15,39,54
2017,35,Newcastle,10,41,-8,35,43
2017,35,Bournemouth,11,38,-15,41,56
2017,35,Watford,12,37,-18,42,60
2017,35,West Ham,13,36,-18,41,59
2017,35,Brighton,14,35,-17,32,49
2017,35,Huddersfield,15,35,-27,27,54
2017,35,Crystal Palace,16,34,-18,36,54
2017,35,Swansea,17,33,-20,27,47
2017,35,Southampton,18,31,-19,34,53
2017,35,Stoke City,19,28,-33,31,64
2017,35,West Brom,20,24,-25,27,52
2017,36,Man City,1,93,75,101,26
2017,36,Man Utd,2,75,39,65,26
2017,36,Liverpool,3,71,43,80,37
2017,36,Spurs,4,71,36,67,31
2017,36,Chelsea,5,64,25,60,35
2017,36,Arsenal,6,57,18,67,49
2017,36,Burnley,7,53,3,35,32
2017,36,Leicester,8,47,4,52,48
2017,36,Everton,9,45,-14,40,54
2017,36,Newcastle,10,41,-9,35,44
2017,36,Bournemouth,11,38,-17,41,58
2017,36,Watford,12,38,-18,42,60
2017,36,Brighton,13,36,-17,33,50
2017,36,West Ham,14,36,-21,42,63
2017,36,Huddersfield,15,36,-27,28,55
2017,36,Crystal Palace,16,35,-18,36,54
2017,36,Swansea,17,33,-25,27,52
2017,36,Southampton,18,32,-19,34,53
2017,36,Stoke City,19,29,-33,32,65
2017,36,West Brom,20,25,-25,29,54
2017,37,Man City,1,96,78,105,27
2017,37,Man Utd,2,78,40,67,27
2017,37,Spurs,3,74,38,69,31
2017,37,Liverpool,4,72,43,80,37
2017,37,Chelsea,5,67,26,61,35
2017,37,Arsenal,6,57,17,68,51
2017,37,Burnley,7,54,3,35,32
2017,37,Everton,8,48,-12,42,54
2017,37,Leicester,9,47,-1,52,53
2017,37,Newcastle,10,41,-10,35,45
2017,37,Crystal Palace,11,38,-13,41,54
2017,37,Bournemouth,12,38,-18,42,60
2017,37,Watford,13,38,-20,42,62
2017,37,Brighton,14,37,-17,33,50
2017,37,West Ham,15,36,-24,43,67
2017,37,Huddersfield,16,36,-29,28,57
2017,37,Southampton,17,35,-18,36,54
2017,37,Swansea,18,33,-26,27,53
2017,37,Stoke City,19,30,-33,32,65
2017,37,West Brom,20,28,-24,30,54
2017,38,Man City,1,97,78,105,27
2017,38,Man Utd,2,78,39,67,28
2017,38,Spurs,3,74,37,69,32
2017,38,Liverpool,4,72,42,80,38
2017,38,Chelsea,5,70,27,62,35
2017,38,Arsenal,6,60,22,73,51
2017,38,Burnley,7,54,-2,35,37
2017,38,Everton,8,49,-12,43,55
2017,38,Leicester,9,47,-3,52,55
2017,38,Newcastle,10,41,-11,36,47
2017,38,Crystal Palace,11,41,-12,43,55
2017,38,Bournemouth,12,41,-17,43,60
2017,38,Watford,13,41,-19,44,63
2017,38,Brighton,14,40,-16,34,50
2017,38,West Ham,15,39,-22,45,67
2017,38,Huddersfield,16,37,-29,28,57
2017,38,Southampton,17,36,-18,37,55
2017,38,Swansea,18,33,-27,27,54
2017,38,West Brom,19,31,-23,31,54
2017,38,Stoke City,20,30,-34,33,67
2017,39,Man City,1,100,79,106,27
2017,39,Man Utd,2,81,40,68,28
2017,39,Spurs,3,77,38,74,36
2017,39,Liverpool,4,75,46,84,38
2017,39,Chelsea,5,70,24,62,38
2017,39,Arsenal,6,63,23,74,51
2017,39,Burnley,7,54,-3,36,39
2017,39,Everton,8,49,-14,44,58
2017,39,Leicester,9,47,-4,56,60
2017,39,Newcastle,10,44,-8,39,47
2017,39,Crystal Palace,11,44,-10,45,55
2017,39,Bournemouth,12,44,-16,45,61
2017,39,West Ham,13,42,-20,48,68
2017,39,Watford,14,41,-20,44,64
2017,39,Brighton,15,40,-20,34,54
2017,39,Huddersfield,16,37,-30,28,58
2017,39,Southampton,17,36,-19,37,56
2017,39,Swansea,18,33,-28,28,56
2017,39,Stoke City,19,33,-33,35,68
2017,39,West Brom,20,31,-25,31,56
2018,2,Liverpool,1,3,4,4,0
2018,2,Chelsea,2,3,3,3,0
2018,2,Man City,3,3,2,2,0
2018,2,Crystal Palace,4,3,2,2,0
2018,2,Bournemouth,5,3,2,2,0
2018,2,Watford,6,3,2,2,0
2018,2,Man Utd,7,3,1,2,1
2018,2,Spurs,8,3,1,2,1
2018,2,Everton,9,1,0,2,2
2018,2,Wolves,10,1,0,2,2
2018,2,Burnley,11,1,0,0,0
2018,2,Southampton,12,1,0,0,0
2018,2,Leicester,13,0,-1,1,2
2018,2,Newcastle,14,0,-1,1,2
2018,2,Arsenal,15,0,-2,0,2
2018,2,Brighton,16,0,-2,0,2
2018,2,Cardiff,17,0,-2,0,2
2018,2,Fulham,18,0,-2,0,2
2018,2,Huddersfield,19,0,-3,0,3
2018,2,West Ham,20,0,-4,0,4
2018,3,Man City,1,6,7,8,1
2018,3,Liverpool,2,6,6,6,0
2018,3,Chelsea,3,6,4,6,2
2018,3,Watford,4,6,4,5,1
2018,3,Spurs,5,6,3,5,2
2018,3,Bournemouth,6,6,3,4,1
2018,3,Everton,7,4,1,4,3
2018,3,Leicester,8,3,1,3,2
2018,3,Man Utd,9,3,0,4,4
2018,3,Crystal Palace,10,3,0,2,2
2018,3,Brighton,11,3,-1,3,4
2018,3,Newcastle,12,1,-1,1,2
2018,3,Southampton,13,1,-1,1,2
2018,3,Wolves,14,1,-2,2,4
2018,3,Burnley,15,1,-2,1,3
2018,3,Cardiff,16,1,-2,0,2
2018,3,Arsenal,17,0,-3,2,5
2018,3,Fulham,18,0,-4,1,5
2018,3,West Ham,19,0,-5,1,6
2018,3,Huddersfield,20,0,-8,1,9
2018,4,Liverpool,1,9,7,7,0
2018,4,Spurs,2,9,6,8,2
2018,4,Chelsea,3,9,5,8,3
2018,4,Watford,4,9,5,7,2
2018,4,Man City,5,7,7,9,2
2018,4,Bournemouth,6,7,3,6,3
2018,4,Leicester,7,6,2,5,3
2018,4,Everton,8,5,1,6,5
2018,4,Arsenal,9,3,-1,5,6
2018,4,Crystal Palace,10,3,-1,3,4
2018,4,Fulham,11,3,-2,5,7
2018,4,Brighton,12,3,-2,3,5
2018,4,Man Utd,13,3,-3,4,7
2018,4,Wolves,14,2,-2,3,5
2018,4,Cardiff,15,2,-2,0,2
2018,4,Newcastle,16,1,-2,2,4
2018,4,Southampton,17,1,-2,2,4
2018,4,Burnley,18,1,-4,3,7
2018,4,Huddersfield,19,1,-8,1,9
2018,4,West Ham,20,0,-7,2,9
2018,5,Liverpool,1,12,8,9,1
2018,5,Chelsea,2,12,7,10,3
2018,5,Watford,3,12,6,9,3
2018,5,Man City,4,10,8,11,3
2018,5,Spurs,5,9,5,9,4
2018,5,Bournemouth,6,7,1,6,5
2018,5,Everton,7,6,1,7,6
2018,5,Leicester,8,6,1,6,5
2018,5,Arsenal,9,6,0,8,8
2018,5,Man Utd,10,6,-1,6,7
2018,5,Wolves,11,5,-1,4,5
2018,5,Southampton,12,4,0,4,4
2018,5,Fulham,13,4,-2,7,9
2018,5,Brighton,14,4,-2,5,7
2018,5,Crystal Palace,15,3,-3,3,6
2018,5,Cardiff,16,2,-3,2,5
2018,5,Huddersfield,17,2,-8,2,10
2018,5,Newcastle,18,1,-3,3,6
2018,5,Burnley,19,1,-6,3,9
2018,5,West Ham,20,0,-8,2,10
2018,6,Chelsea,1,15,10,14,4
2018,6,Liverpool,2,15,9,11,2
2018,6,Man City,3,13,11,14,3
2018,6,Watford,4,12,5,10,5
2018,6,Bournemouth,5,10,3,10,7
2018,6,Spurs,6,9,4,10,6
2018,6,Arsenal,7,9,1,10,9
2018,6,Man Utd,8,9,0,8,8
2018,6,Wolves,9,8,0,5,5
2018,6,Everton,10,6,-1,8,9
2018,6,Leicester,11,6,-1,8,9
2018,6,Crystal Palace,12,6,-2,4,6
2018,6,Southampton,13,5,0,6,6
2018,6,Brighton,14,5,-2,7,9
2018,6,Fulham,15,4,-5,7,12
2018,6,West Ham,16,3,-6,5,11
2018,6,Cardiff,17,2,-6,3,9
2018,6,Huddersfield,18,2,-9,2,11
2018,6,Newcastle,19,1,-4,4,8
2018,6,Burnley,20,1,-7,3,10
2018,7,Liverpool,1,18,12,14,2
2018,7,Man City,2,16,16,19,3
2018,7,Chelsea,3,16,10,14,4
2018,7,Watford,4,13,5,11,6
2018,7,Spurs,5,12,5,12,7
2018,7,Arsenal,6,12,3,12,9
2018,7,Man Utd,7,10,0,9,9
2018,7,Bournemouth,8,10,-1,10,11
2018,7,Leicester,9,9,1,11,10
2018,7,Wolves,10,9,0,6,6
2018,7,Crystal Palace,11,7,-2,4,6
2018,7,Everton,12,6,-3,8,11
2018,7,Brighton,13,5,-3,8,11
2018,7,Southampton,14,5,-3,6,9
2018,7,Fulham,15,5,-5,8,13
2018,7,Burnley,16,4,-3,7,10
2018,7,West Ham,17,4,-6,5,11
2018,7,Newcastle,18,2,-4,4,8
2018,7,Huddersfield,19,2,-11,3,14
2018,7,Cardiff,20,2,-11,3,14
2018,8,Man City,1,19,18,21,3
2018,8,Liverpool,2,19,12,15,3
2018,8,Chelsea,3,17,10,15,5
2018,8,Spurs,4,15,7,14,7
2018,8,Arsenal,5,15,5,14,9
2018,8,Watford,6,13,3,11,8
2018,8,Bournemouth,7,13,0,12,12
2018,8,Leicester,8,12,3,13,10
2018,8,Wolves,9,12,2,8,6
2018,8,Man Utd,10,10,-2,10,12
2018,8,Everton,11,9,0,11,11
2018,8,Burnley,12,7,-2,9,11
2018,8,Crystal Palace,13,7,-3,5,8
2018,8,West Ham,14,7,-4,8,12
2018,8,Brighton,15,5,-5,8,13
2018,8,Southampton,16,5,-5,6,11
2018,8,Fulham,17,5,-8,8,16
2018,8,Newcastle,18,2,-6,4,10
2018,8,Cardiff,19,2,-12,4,16
2018,8,Huddersfield,20,2,-13,3,16
2018,9,Man City,1,20,18,21,3
2018,9,Chelsea,2,20,13,18,5
2018,9,Liverpool,3,20,12,15,3
2018,9,Arsenal,4,18,9,19,10
2018,9,Spurs,5,18,8,15,7
2018,9,Bournemouth,6,16,4,16,12
2018,9,Wolves,7,15,3,9,6
2018,9,Man Utd,8,13,-1,13,14
2018,9,Watford,9,13,-1,11,12
2018,9,Leicester,10,12,2,14,12
2018,9,Everton,11,12,1,13,12
2018,9,Burnley,12,8,-2,10,12
2018,9,Brighton,13,8,-4,9,13
2018,9,Crystal Palace,14,7,-4,5,9
2018,9,West Ham,15,7,-5,8,13
2018,9,Southampton,16,5,-8,6,14
2018,9,Fulham,17,5,-12,9,21
2018,9,Huddersfield,18,3,-13,4,17
2018,9,Newcastle,19,2,-7,6,13
2018,9,Cardiff,20,2,-13,4,17
2018,10,Man City,1,23,23,26,3
2018,10,Liverpool,2,23,13,16,3
2018,10,Chelsea,3,21,13,20,7
2018,10,Arsenal,4,21,11,22,11
2018,10,Spurs,5,21,9,16,7
2018,10,Bournemouth,6,17,4,16,12
2018,10,Watford,7,16,1,13,12
2018,10,Everton,8,15,3,15,12
2018,10,Wolves,9,15,1,9,8
2018,10,Man Utd,10,14,-1,15,16
2018,10,Leicester,11,12,0,15,15
2018,10,Brighton,12,11,-3,10,13
2018,10,Burnley,13,8,-7,10,17
2018,10,West Ham,14,7,-6,8,14
2018,10,Crystal Palace,15,7,-6,5,11
2018,10,Southampton,16,6,-8,6,14
2018,10,Cardiff,17,5,-11,8,19
2018,10,Fulham,18,5,-14,11,25
2018,10,Huddersfield,19,3,-14,4,18
2018,10,Newcastle,20,2,-8,6,14
2018,11,Man City,1,26,24,27,3
2018,11,Liverpool,2,26,16,20,4
2018,11,Chelsea,3,24,17,24,7
2018,11,Arsenal,4,22,11,24,13
2018,11,Spurs,5,21,8,16,8
2018,11,Bournemouth,6,20,7,19,12
2018,11,Watford,7,19,4,16,12
2018,11,Man Utd,8,17,0,17,17
2018,11,Everton,9,15,2,16,14
2018,11,Wolves,10,15,0,9,9
2018,11,Brighton,11,14,-2,11,13
2018,11,Leicester,12,13,0,16,16
2018,11,West Ham,13,8,-6,9,15
2018,11,Crystal Palace,14,8,-6,7,13
2018,11,Burnley,15,8,-11,10,21
2018,11,Southampton,16,7,-8,6,14
2018,11,Cardiff,17,5,-14,9,23
2018,11,Fulham,18,5,-17,11,28
2018,11,Newcastle,19,3,-8,6,14
2018,11,Huddersfield,20,3,-17,4,21
2018,12,Man City,1,29,29,33,4
2018,12,Chelsea,2,27,19,27,8
2018,12,Liverpool,3,27,16,21,5
2018,12,Spurs,4,24,9,19,10
2018,12,Arsenal,5,23,11,25,14
2018,12,Bournemouth,6,20,6,20,14
2018,12,Man Utd,7,20,1,19,18
2018,12,Watford,8,19,3,16,13
2018,12,Everton,9,18,4,19,15
2018,12,Leicester,10,16,1,17,16
2018,12,Wolves,11,15,-1,11,12
2018,12,Brighton,12,14,-4,12,16
2018,12,West Ham,13,11,-4,13,17
2018,12,Crystal Palace,14,8,-8,8,16
2018,12,Burnley,15,8,-13,12,25
2018,12,Southampton,16,7,-13,7,20
2018,12,Newcastle,17,6,-7,7,14
2018,12,Huddersfield,18,6,-16,5,21
2018,12,Cardiff,19,5,-15,9,24
2018,12,Fulham,20,5,-18,11,29
2018,13,Man City,1,32,31,36,5
2018,13,Liverpool,2,30,18,23,5
2018,13,Chelsea,3,28,19,27,8
2018,13,Spurs,4,27,10,20,10
2018,13,Arsenal,5,24,11,26,15
2018,13,Bournemouth,6,20,5,21,16
2018,13,Watford,7,20,3,17,14
2018,13,Man Utd,8,20,-1,20,21
2018,13,Everton,9,19,4,19,15
2018,13,Leicester,10,17,1,17,16
2018,13,Wolves,11,16,-1,12,13
2018,13,Brighton,12,14,-5,13,18
2018,13,West Ham,13,12,-4,14,18
2018,13,Newcastle,14,9,-6,9,15
2018,13,Burnley,15,9,-13,12,25
2018,13,Crystal Palace,16,8,-9,8,17
2018,13,Southampton,17,8,-13,8,21
2018,13,Cardiff,18,8,-14,11,25
2018,13,Huddersfield,19,7,-16,6,22
2018,13,Fulham,20,5,-20,11,31
2018,14,Man City,1,35,35,40,5
2018,14,Liverpool,2,33,21,26,5
2018,14,Spurs,3,30,12,23,11
2018,14,Chelsea,4,28,17,28,11
2018,14,Arsenal,5,27,12,28,16
2018,14,Everton,6,22,5,20,15
2018,14,Man Utd,7,21,-1,20,21
2018,14,Bournemouth,8,20,4,22,18
2018,14,Watford,9,20,0,17,17
2018,14,Leicester,10,18,1,18,17
2018,14,Wolves,11,16,-3,12,15
2018,14,Brighton,12,15,-5,14,19
2018,14,Newcastle,13,12,-5,11,16
2018,14,West Ham,14,12,-8,14,22
2018,14,Huddersfield,15,10,-14,8,22
2018,14,Crystal Palace,16,9,-9,8,17
2018,14,Burnley,17,9,-14,13,27
2018,14,Southampton,18,8,-14,10,24
2018,14,Cardiff,19,8,-15,11,26
2018,14,Fulham,20,8,-19,14,33
2018,15,Man City,1,38,37,43,6
2018,15,Liverpool,2,36,22,27,5
2018,15,Chelsea,3,31,19,30,11
2018,15,Arsenal,4,30,14,32,18
2018,15,Spurs,5,30,10,25,15
2018,15,Everton,6,22,4,20,16
2018,15,Man Utd,7,22,-1,22,23
2018,15,Leicester,8,21,3,20,17
2018,15,Bournemouth,9,20,2,23,21
2018,15,Watford,10,20,-2,17,19
2018,15,Brighton,11,18,-4,16,20
2018,15,Wolves,12,16,-4,13,17
2018,15,West Ham,13,15,-5,17,22
2018,15,Crystal Palace,14,12,-7,10,17
2018,15,Newcastle,15,12,-8,11,19
2018,15,Cardiff,16,11,-14,13,27
2018,15,Huddersfield,17,10,-15,9,24
2018,15,Southampton,18,9,-14,12,26
2018,15,Burnley,19,9,-16,13,29
2018,15,Fulham,20,8,-21,14,35
2018,16,Man City,1,41,38,45,7
2018,16,Liverpool,2,39,24,30,6
2018,16,Spurs,3,33,12,28,16
2018,16,Chelsea,4,31,18,31,13
2018,16,Arsenal,5,31,14,34,20
2018,16,Everton,6,23,4,21,17
2018,16,Bournemouth,7,23,3,25,22
2018,16,Man Utd,8,23,-1,24,25
2018,16,Leicester,9,22,3,21,18
2018,16,Brighton,10,21,-2,19,21
2018,16,Watford,11,20,-3,18,21
2018,16,Wolves,12,19,-3,15,18
2018,16,West Ham,13,18,-3,20,23
2018,16,Newcastle,14,13,-8,12,20
2018,16,Crystal Palace,15,12,-9,11,20
2018,16,Cardiff,16,11,-16,14,30
2018,16,Huddersfield,17,10,-16,10,26
2018,16,Southampton,18,9,-16,13,29
2018,16,Burnley,19,9,-18,14,32
2018,16,Fulham,20,9,-21,15,36
2018,17,Liverpool,1,42,28,34,6
2018,17,Man City,2,41,36,45,9
2018,17,Spurs,3,36,14,30,16
2018,17,Chelsea,4,34,20,33,13
2018,17,Arsenal,5,34,15,35,20
2018,17,Man Utd,6,26,2,28,26
2018,17,Everton,7,24,4,23,19
2018,17,Bournemouth,8,23,-1,25,26
2018,17,Leicester,9,22,1,21,20
2018,17,Wolves,10,22,-2,17,19
2018,17,West Ham,11,21,-2,23,25
2018,17,Watford,12,21,-3,20,23
2018,17,Brighton,13,21,-3,19,22
2018,17,Cardiff,14,14,-15,15,30
2018,17,Newcastle,15,13,-9,13,22
2018,17,Crystal Palace,16,12,-10,13,23
2018,17,Burnley,17,12,-17,15,32
2018,17,Huddersfield,18,10,-17,10,27
2018,17,Southampton,19,9,-17,13,30
2018,17,Fulham,20,9,-24,16,40
2018,18,Liverpool,1,45,30,37,7
2018,18,Man City,2,44,38,48,10
2018,18,Spurs,3,39,15,31,16
2018,18,Chelsea,4,37,21,35,14
2018,18,Arsenal,5,34,14,37,23
2018,18,Man Utd,6,26,0,29,29
2018,18,Wolves,7,25,0,19,19
2018,18,Everton,8,24,2,24,22
2018,18,West Ham,9,24,0,25,25
2018,18,Watford,10,24,-2,23,25
2018,18,Bournemouth,11,23,-3,25,28
2018,18,Leicester,12,22,0,21,21
2018,18,Brighton,13,21,-4,20,24
2018,18,Newcastle,14,16,-8,14,22
2018,18,Crystal Palace,15,15,-9,14,23
2018,18,Cardiff,16,14,-16,17,33
2018,18,Southampton,17,12,-16,16,32
2018,18,Burnley,18,12,-18,15,33
2018,18,Huddersfield,19,10,-18,10,28
2018,18,Fulham,20,9,-26,16,42
2018,19,Liverpool,1,48,32,39,7
2018,19,Man City,2,44,37,50,13
2018,19,Spurs,3,42,19,37,18
2018,19,Chelsea,4,37,20,35,15
2018,19,Arsenal,5,37,16,40,24
2018,19,Man Utd,6,29,4,34,30
2018,19,Watford,7,27,0,25,25
2018,19,Bournemouth,8,26,-1,27,28
2018,19,Leicester,9,25,1,22,21
2018,19,Wolves,10,25,-2,19,21
2018,19,Everton,11,24,-2,26,28
2018,19,West Ham,12,24,-2,25,27
2018,19,Brighton,13,21,-6,20,26
2018,19,Crystal Palace,14,18,-8,17,25
2018,19,Newcastle,15,17,-8,14,22
2018,19,Southampton,16,15,-14,19,33
2018,19,Cardiff,17,14,-20,18,38
2018,19,Burnley,18,12,-20,16,36
2018,19,Huddersfield,19,10,-20,11,31
2018,19,Fulham,20,10,-26,16,42
2018,20,Liverpool,1,51,36,43,7
2018,20,Spurs,2,45,24,42,18
2018,20,Man City,3,44,36,51,15
2018,20,Chelsea,4,40,21,37,16
2018,20,Arsenal,5,38,16,41,25
2018,20,Man Utd,6,32,6,37,31
2018,20,Leicester,7,28,2,24,22
2018,20,Everton,8,27,2,31,29
2018,20,West Ham,9,27,-1,27,28
2018,20,Watford,10,27,-1,26,27
2018,20,Wolves,11,26,-2,20,22
2018,20,Bournemouth,12,26,-6,27,33
2018,20,Brighton,13,22,-6,21,27
2018,20,Crystal Palace,14,19,-8,17,25
2018,20,Newcastle,15,17,-12,14,26
2018,20,Southampton,16,15,-15,20,35
2018,20,Cardiff,17,15,-20,18,38
2018,20,Burnley,18,12,-24,17,41
2018,20,Fulham,19,11,-26,17,43
2018,20,Huddersfield,20,10,-22,12,34
2018,21,Liverpool,1,54,40,48,8
2018,21,Man City,2,47,38,54,16
2018,21,Spurs,3,45,22,43,21
2018,21,Chelsea,4,43,22,38,16
2018,21,Arsenal,5,38,12,42,30
2018,21,Man Utd,6,35,9,41,32
2018,21,Wolves,7,29,0,23,23
2018,21,Leicester,8,28,1,24,23
2018,21,Watford,9,28,-1,27,28
2018,21,Everton,10,27,1,31,30
2018,21,West Ham,11,27,-3,27,30
2018,21,Bournemouth,12,26,-9,28,37
2018,21,Brighton,13,25,-5,22,27
2018,21,Crystal Palace,14,19,-9,17,26
2018,21,Newcastle,15,18,-12,15,27
2018,21,Cardiff,16,18,-19,19,38
2018,21,Southampton,17,15,-17,21,38
2018,21,Burnley,18,15,-22,19,41
2018,21,Fulham,19,14,-25,18,43
2018,21,Huddersfield,20,10,-23,12,35
2018,22,Liverpool,1,54,39,49,10
2018,22,Man City,2,50,39,56,17
2018,22,Spurs,3,48,25,46,21
2018,22,Chelsea,4,44,22,38,16
2018,22,Arsenal,5,41,15,46,31
2018,22,Man Utd,6,38,11,43,32
2018,22,Leicester,7,31,2,25,23
2018,22,Watford,8,29,-1,30,31
2018,22,Wolves,9,29,-2,23,25
2018,22,West Ham,10,28,-3,29,32
2018,22,Everton,11,27,0,31,31
2018,22,Bournemouth,12,27,-9,31,40
2018,22,Brighton,13,26,-5,24,29
2018,22,Crystal Palace,14,22,-7,19,26
2018,22,Newcastle,15,18,-14,15,29
2018,22,Burnley,16,18,-21,21,42
2018,22,Cardiff,17,18,-22,19,41
2018,22,Southampton,18,16,-17,21,38
2018,22,Fulham,19,14,-28,19,47
2018,22,Huddersfield,20,10,-24,13,37
2018,23,Liverpool,1,57,40,50,10
2018,23,Man City,2,53,42,59,17
2018,23,Spurs,3,48,24,46,22
2018,23,Chelsea,4,47,23,40,17
2018,23,Arsenal,5,41,14,46,32
2018,23,Man Utd,6,41,12,44,32
2018,23,Watford,7,32,0,32,32
2018,23,Leicester,8,31,1,26,25
2018,23,West Ham,9,31,-2,30,32
2018,23,Everton,10,30,2,33,31
2018,23,Wolves,11,29,-5,23,28
2018,23,Bournemouth,12,27,-11,31,42
2018,23,Brighton,13,26,-6,24,30
2018,23,Crystal Palace,14,22,-8,20,28
2018,23,Burnley,15,21,-20,23,43
2018,23,Southampton,16,19,-16,23,39
2018,23,Cardiff,17,19,-22,19,41
2018,23,Newcastle,18,18,-15,16,31
2018,23,Fulham,19,14,-29,20,49
2018,23,Huddersfield,20,11,-24,13,37
2018,24,Liverpool,1,60,41,54,13
2018,24,Man City,2,56,45,62,17
2018,24,Spurs,3,51,25,48,23
2018,24,Chelsea,4,47,21,40,19
2018,24,Arsenal,5,44,16,48,32
2018,24,Man Utd,6,44,13,46,33
2018,24,Watford,7,33,0,32,32
2018,24,Wolves,8,32,-4,27,31
2018,24,Leicester,9,31,0,29,29
2018,24,West Ham,10,31,-4,30,34
2018,24,Everton,11,30,1,34,33
2018,24,Bournemouth,12,30,-9,33,42
2018,24,Brighton,13,26,-7,25,32
2018,24,Crystal Palace,14,22,-9,23,32
2018,24,Southampton,15,22,-15,25,40
2018,24,Burnley,16,22,-20,23,43
2018,24,Newcastle,17,21,-12,19,31
2018,24,Cardiff,18,19,-25,19,44
2018,24,Fulham,19,14,-30,21,51
2018,24,Huddersfield,20,11,-27,13,40
2018,25,Liverpool,1,61,41,55,14
2018,25,Man City,2,56,44,63,19
2018,25,Spurs,3,54,26,50,24
2018,25,Arsenal,4,47,17,50,33
2018,25,Chelsea,5,47,17,40,23
2018,25,Man Utd,6,45,13,48,35
2018,25,Wolves,7,35,-1,30,31
2018,25,Everton,8,33,2,35,33
2018,25,Watford,9,33,-1,33,34
2018,25,Bournemouth,10,33,-5,37,42
2018,25,Leicester,11,32,0,30,30
2018,25,West Ham,12,31,-7,30,37
2018,25,Brighton,13,26,-9,27,36
2018,25,Newcastle,14,24,-11,21,32
2018,25,Crystal Palace,15,23,-9,24,33
2018,25,Southampton,16,23,-15,26,41
2018,25,Burnley,17,23,-20,25,45
2018,25,Cardiff,18,19,-26,20,46
2018,25,Fulham,19,17,-28,25,53
2018,25,Huddersfield,20,11,-28,13,41
2018,26,Liverpool,1,62,41,56,15
2018,26,Man City,2,59,46,66,20
2018,26,Spurs,3,57,27,51,24
2018,26,Chelsea,4,50,22,45,23
2018,26,Man Utd,5,48,14,49,35
2018,26,Arsenal,6,47,15,51,36
2018,26,Wolves,7,38,1,33,32
2018,26,Watford,8,34,-1,33,34
2018,26,Everton,9,33,0,36,36
2018,26,Bournemouth,10,33,-7,37,44
2018,26,Leicester,11,32,-1,30,31
2018,26,West Ham,12,32,-7,31,38
2018,26,Brighton,13,27,-9,27,36
2018,26,Crystal Palace,14,26,-7,26,33
2018,26,Newcastle,15,24,-12,21,33
2018,26,Southampton,16,24,-15,27,42
2018,26,Burnley,17,24,-20,26,46
2018,26,Cardiff,18,22,-24,22,46
2018,26,Fulham,19,17,-30,25,55
2018,26,Huddersfield,20,11,-33,13,46
2018,27,Liverpool,1,65,44,59,15
2018,27,Man City,2,62,52,72,20
2018,27,Spurs,3,60,29,54,25
2018,27,Man Utd,4,51,17,52,35
2018,27,Arsenal,5,50,16,53,37
2018,27,Chelsea,6,50,16,45,29
2018,27,Wolves,7,39,1,34,33
2018,27,Watford,8,37,0,34,34
2018,27,Everton,9,33,-1,36,37
2018,27,West Ham,10,33,-7,32,39
2018,27,Bournemouth,11,33,-10,37,47
2018,27,Leicester,12,32,-3,31,34
2018,27,Crystal Palace,13,27,-7,27,34
2018,27,Brighton,14,27,-11,28,39
2018,27,Burnley,15,27,-18,29,47
2018,27,Newcastle,16,25,-12,22,34
2018,27,Cardiff,17,25,-23,24,47
2018,27,Southampton,18,24,-16,28,44
2018,27,Fulham,19,17,-33,25,58
2018,27,Huddersfield,20,11,-34,14,48
2018,28,Liverpool,1,66,44,59,15
2018,28,Man City,2,65,54,74,20
2018,28,Spurs,3,60,28,55,27
2018,28,Chelsea,4,53,19,48,29
2018,28,Arsenal,5,53,18,55,37
2018,28,Man Utd,6,52,17,52,35
2018,28,Watford,7,40,4,39,35
2018,28,Wolves,8,40,1,35,34
2018,28,West Ham,9,36,-5,35,40
2018,28,Bournemouth,10,34,-10,38,48
2018,28,Everton,11,33,-3,36,39
2018,28,Leicester,12,32,-6,32,38
2018,28,Crystal Palace,13,30,-4,31,35
2018,28,Burnley,14,30,-17,31,48
2018,28,Newcastle,15,28,-10,24,34
2018,28,Brighton,16,27,-14,28,42
2018,28,Cardiff,17,25,-27,25,52
2018,28,Southampton,18,24,-18,28,46
2018,28,Fulham,19,17,-35,26,61
2018,28,Huddersfield,20,11,-36,14,50
2018,29,Liverpool,1,69,49,64,15
2018,29,Man City,2,68,55,75,20
2018,29,Spurs,3,60,26,55,29
2018,29,Arsenal,4,56,22,60,38
2018,29,Chelsea,5,56,21,50,29
2018,29,Man Utd,6,55,19,55,36
2018,29,Wolves,7,40,0,35,35
2018,29,Watford,8,40,-1,39,40
2018,29,Everton,9,36,0,39,39
2018,29,West Ham,10,36,-6,35,41
2018,29,Leicester,11,35,-5,34,39
2018,29,Bournemouth,12,34,-14,39,53
2018,29,Newcastle,13,31,-8,26,34
2018,29,Crystal Palace,14,30,-6,32,38
2018,29,Burnley,15,30,-19,31,50
2018,29,Brighton,16,27,-15,29,44
2018,29,Southampton,17,27,-16,30,46
2018,29,Cardiff,18,25,-30,25,55
2018,29,Fulham,19,17,-37,26,63
2018,29,Huddersfield,20,14,-35,15,50
2018,30,Man City,1,71,56,76,20
2018,30,Liverpool,2,70,49,64,15
2018,30,Spurs,3,61,26,56,30
2018,30,Chelsea,4,59,22,52,30
2018,30,Man Utd,5,58,20,58,38
2018,30,Arsenal,6,57,22,61,39
2018,30,Wolves,7,43,2,37,35
2018,30,Watford,8,43,0,41,41
2018,30,West Ham,9,39,-4,37,41
2018,30,Everton,10,37,0,39,39
2018,30,Leicester,11,35,-6,35,41
2018,30,Bournemouth,12,34,-15,39,54
2018,30,Crystal Palace,13,33,-4,35,39
2018,30,Newcastle,14,31,-10,26,36
2018,30,Brighton,15,30,-14,30,44
2018,30,Burnley,16,30,-21,32,53
2018,30,Southampton,17,27,-17,32,49
2018,30,Cardiff,18,25,-32,25,57
2018,30,Fulham,19,17,-38,27,65
2018,30,Huddersfield,20,14,-36,15,51
2018,31,Man City,1,74,58,79,21
2018,31,Liverpool,2,73,51,68,17
2018,31,Spurs,3,61,25,57,32
2018,31,Arsenal,4,60,24,63,39
2018,31,Chelsea,5,60,22,53,31
2018,31,Man Utd,6,58,18,58,40
2018,31,Wolves,7,44,2,38,36
2018,31,Watford,8,43,-2,42,44
2018,31,West Ham,9,39,-6,37,43
2018,31,Leicester,10,38,-4,38,42
2018,31,Everton,11,37,-1,41,42
2018,31,Bournemouth,12,37,-13,41,54
2018,31,Newcastle,13,34,-9,29,38
2018,31,Crystal Palace,14,33,-5,36,41
2018,31,Brighton,15,33,-13,32,45
2018,31,Southampton,16,30,-16,34,50
2018,31,Burnley,17,30,-23,34,57
2018,31,Cardiff,18,28,-30,27,57
2018,31,Fulham,19,17,-40,28,68
2018,31,Huddersfield,20,14,-38,15,53
2018,32,Man City,1,77,60,81,21
2018,32,Liverpool,2,76,52,70,18
2018,32,Spurs,3,64,27,59,32
2018,32,Arsenal,4,60,22,64,42
2018,32,Chelsea,5,60,20,53,33
2018,32,Man Utd,6,58,16,58,42
2018,32,Wolves,7,47,4,41,37
2018,32,Watford,8,44,-2,43,45
2018,32,West Ham,9,42,-5,41,46
2018,32,Leicester,10,41,-3,40,43
2018,32,Everton,11,40,1,43,42
2018,32,Bournemouth,12,38,-13,43,56
2018,32,Newcastle,13,35,-9,31,40
2018,32,Crystal Palace,14,33,-7,36,43
2018,32,Brighton,15,33,-15,32,47
2018,32,Southampton,16,31,-16,35,51
2018,32,Cardiff,17,31,-28,29,57
2018,32,Burnley,18,30,-24,35,59
2018,32,Fulham,19,17,-41,29,70
2018,32,Huddersfield,20,14,-39,18,57
2018,33,Man City,1,80,62,83,21
2018,33,Liverpool,2,79,53,72,19
2018,33,Spurs,3,64,26,60,34
2018,33,Arsenal,4,63,24,66,42
2018,33,Chelsea,5,63,21,55,34
2018,33,Man Utd,6,61,17,60,43
2018,33,Wolves,7,47,2,41,39
2018,33,Leicester,8,44,-1,42,43
2018,33,Watford,9,44,-3,44,47
2018,33,Everton,10,43,3,45,42
2018,33,West Ham,11,42,-7,41,48
2018,33,Bournemouth,12,38,-15,43,58
2018,33,Crystal Palace,13,36,-5,38,43
2018,33,Newcastle,14,35,-11,31,42
2018,33,Southampton,15,34,-15,36,51
2018,33,Brighton,16,33,-16,32,48
2018,33,Burnley,17,33,-22,37,59
2018,33,Cardiff,18,31,-29,30,59
2018,33,Fulham,19,17,-43,29,72
2018,33,Huddersfield,20,14,-41,18,59
2018,34,Man City,1,83,64,85,21
2018,34,Liverpool,2,82,55,75,20
2018,34,Spurs,3,67,27,61,34
2018,34,Chelsea,4,66,23,57,34
2018,34,Arsenal,5,63,23,66,43
2018,34,Man Utd,6,61,16,61,45
2018,34,Wolves,7,50,3,43,40
2018,34,Leicester,8,47,2,46,44
2018,34,Watford,9,47,0,48,48
2018,34,Everton,10,46,4,46,42
2018,34,West Ham,11,42,-9,41,50
2018,34,Crystal Palace,12,39,-4,39,43
2018,34,Bournemouth,13,38,-17,44,61
2018,34,Burnley,14,36,-20,40,60
2018,34,Newcastle,15,35,-12,31,43
2018,34,Southampton,16,34,-17,37,54
2018,34,Brighton,17,33,-17,32,49
2018,34,Cardiff,18,31,-31,30,61
2018,34,Fulham,19,17,-46,30,76
2018,34,Huddersfield,20,14,-44,19,63
2018,35,Man City,1,86,66,88,22
2018,35,Liverpool,2,85,57,77,20
2018,35,Spurs,3,70,31,65,34
2018,35,Arsenal,4,66,24,67,43
2018,35,Chelsea,5,66,21,57,36
2018,35,Man Utd,6,64,17,63,46
2018,35,Wolves,7,50,1,44,43
2018,35,Leicester,8,47,1,46,45
2018,35,Watford,9,47,-1,48,49
2018,35,Everton,10,46,2,46,44
2018,35,West Ham,11,42,-10,42,52
2018,35,Bournemouth,12,41,-12,49,61
2018,35,Crystal Palace,13,39,-6,40,46
2018,35,Burnley,14,39,-18,42,60
2018,35,Newcastle,15,38,-11,32,43
2018,35,Southampton,16,37,-15,40,55
2018,35,Brighton,17,33,-22,32,54
2018,35,Cardiff,18,31,-33,30,63
2018,35,Fulham,19,20,-44,32,76
2018,35,Huddersfield,20,14,-48,19,67
2018,36,Man City,1,89,67,89,22
2018,36,Liverpool,2,88,59,79,20
2018,36,Spurs,3,70,30,65,35
2018,36,Chelsea,4,67,21,59,38
2018,36,Arsenal,5,66,23,69,46
2018,36,Man Utd,6,64,13,63,50
2018,36,Wolves,7,51,1,44,43
2018,36,Watford,8,50,0,50,50
2018,36,Everton,9,49,6,50,44
2018,36,Leicester,10,48,1,48,47
2018,36,West Ham,11,43,-10,44,54
2018,36,Crystal Palace,12,42,-5,43,48
2018,36,Newcastle,13,41,-9,35,44
2018,36,Bournemouth,14,41,-13,49,62
2018,36,Burnley,15,40,-18,44,62
2018,36,Southampton,16,37,-17,41,58
2018,36,Brighton,17,34,-22,32,54
2018,36,Cardiff,18,31,-35,30,65
2018,36,Fulham,19,23,-43,33,76
2018,36,Huddersfield,20,14,-49,20,69
2018,37,Man City,1,92,68,90,22
2018,37,Liverpool,2,91,64,84,20
2018,37,Spurs,3,70,29,65,36
2018,37,Chelsea,4,68,21,60,39
2018,37,Arsenal,5,66,20,69,49
2018,37,Man Utd,6,65,13,64,51
2018,37,Wolves,7,54,2,46,44
2018,37,Leicester,8,51,4,51,47
2018,37,Everton,9,50,6,50,44
2018,37,Watford,10,50,-1,51,52
2018,37,West Ham,11,46,-9,45,54
2018,37,Crystal Palace,12,43,-5,43,48
2018,37,Newcastle,13,42,-9,36,45
2018,37,Bournemouth,14,42,-13,52,65
2018,37,Burnley,15,40,-19,44,63
2018,37,Southampton,16,38,-17,44,61
2018,37,Brighton,17,35,-22,33,55
2018,37,Cardiff,18,31,-36,30,66
2018,37,Fulham,19,26,-42,34,76
2018,37,Huddersfield,20,14,-54,20,74
2018,38,Man City,1,95,69,91,22
2018,38,Liverpool,2,94,65,87,22
2018,38,Chelsea,3,71,24,63,39
2018,38,Spurs,4,70,28,65,37
2018,38,Arsenal,5,67,20,70,50
2018,38,Man Utd,6,66,13,65,52
2018,38,Wolves,7,57,3,47,44
2018,38,Everton,8,53,8,52,44
2018,38,Leicester,9,51,3,51,48
2018,38,Watford,10,50,-4,51,55
2018,38,West Ham,11,49,-6,48,54
2018,38,Crystal Palace,12,46,-4,46,50
2018,38,Bournemouth,13,45,-12,53,65
2018,38,Newcastle,14,42,-10,38,48
2018,38,Burnley,15,40,-21,44,65
2018,38,Southampton,16,38,-20,44,64
2018,38,Brighton,17,36,-22,34,56
2018,38,Cardiff,18,31,-37,32,69
2018,38,Fulham,19,26,-43,34,77
2018,38,Huddersfield,20,15,-54,21,75
2018,39,Man City,1,98,72,95,23
2018,39,Liverpool,2,97,67,89,22
2018,39,Chelsea,3,72,24,63,39
2018,39,Spurs,4,71,28,67,39
2018,39,Arsenal,5,70,22,73,51
2018,39,Man Utd,6,66,11,65,54
2018,39,Wolves,7,57,1,47,46
2018,39,Everton,8,54,8,54,46
2018,39,Leicester,9,52,3,51,48
2018,39,West Ham,10,52,-3,52,55
2018,39,Watford,11,50,-7,52,59
2018,39,Crystal Palace,12,49,-2,51,53
2018,39,Newcastle,13,45,-6,42,48
2018,39,Bournemouth,14,45,-14,56,70
2018,39,Burnley,15,40,-23,45,68
2018,39,Southampton,16,39,-20,45,65
2018,39,Brighton,17,36,-25,35,60
2018,39,Cardiff,18,34,-35,34,69
2018,39,Fulham,19,26,-47,34,81
2018,39,Huddersfield,20,16,-54,22,76
