match_year,match_round,team,team_rank,team_points,team_goal_difference,team_goal_fatti,team_goal_subiti
2010,2,Chelsea,1,3,6,6,0
2010,2,Blackpool,2,3,4,4,0
2010,2,Aston Villa,3,3,3,3,0
2010,2,Man Utd,4,3,3,3,0
2010,2,Wolves,5,3,1,2,1
2010,2,Blackburn,6,3,1,1,0
2010,2,Sunderland,7,1,0,2,2
2010,2,Birmingham,8,1,0,2,2
2010,2,Arsenal,9,1,0,1,1
2010,2,Liverpool,10,1,0,1,1
2010,2,Spurs,11,1,0,0,0
2010,2,Man City,12,1,0,0,0
2010,2,Bolton,13,1,0,0,0
2010,2,Fulham,14,1,0,0,0
2010,2,Stoke City,15,0,-1,1,2
2010,2,Everton,16,0,-1,0,1
2010,2,West Ham,17,0,-3,0,3
2010,2,Newcastle,18,0,-3,0,3
2010,2,Wigan,19,0,-4,0,4
2010,2,West Brom,20,0,-6,0,6
2010,3,Chelsea,1,6,12,12,0
2010,3,Arsenal,2,4,6,7,1
2010,3,Man Utd,3,4,3,5,2
2010,3,Man City,4,4,3,3,0
2010,3,Bolton,5,4,2,3,1
2010,3,Birmingham,6,4,1,4,3
2010,3,Wolves,7,4,1,3,2
2010,3,Spurs,8,4,1,2,1
2010,3,Newcastle,9,3,3,6,3
2010,3,Blackburn,10,3,0,2,2
2010,3,Blackpool,11,3,-2,4,6
2010,3,Aston Villa,12,3,-3,3,6
2010,3,West Brom,13,3,-5,1,6
2010,3,Fulham,14,2,0,2,2
2010,3,Sunderland,15,1,-1,2,3
2010,3,Everton,16,1,-1,1,2
2010,3,Liverpool,17,1,-3,1,4
2010,3,Stoke City,18,0,-2,2,4
2010,3,West Ham,19,0,-5,1,6
2010,3,Wigan,20,0,-10,0,10
2010,4,Chelsea,1,9,14,14,0
2010,4,Arsenal,2,7,7,9,2
2010,4,Man Utd,3,7,6,8,2
2010,4,Aston Villa,4,6,-2,4,6
2010,4,Bolton,5,5,2,5,3
2010,4,Birmingham,6,5,1,6,5
2010,4,Wolves,7,5,1,4,3
2010,4,Newcastle,8,4,3,7,4
2010,4,Man City,9,4,2,3,1
2010,4,Sunderland,10,4,0,3,3
2010,4,Spurs,11,4,0,2,2
2010,4,Blackpool,12,4,-2,6,8
2010,4,Liverpool,13,4,-2,2,4
2010,4,Fulham,14,3,0,4,4
2010,4,Blackburn,15,3,-1,3,4
2010,4,West Brom,16,3,-6,1,7
2010,4,Wigan,17,3,-9,1,10
2010,4,Everton,18,1,-2,1,3
2010,4,Stoke City,19,0,-4,2,6
2010,4,West Ham,20,0,-8,1,9
2010,5,Chelsea,1,12,16,17,1
2010,5,Arsenal,2,10,10,13,3
2010,5,Man Utd,3,8,6,11,5
2010,5,Blackpool,4,7,0,8,8
2010,5,Birmingham,5,6,1,6,5
2010,5,Fulham,6,6,1,6,5
2010,5,Aston Villa,7,6,-3,5,8
2010,5,Man City,8,5,2,4,2
2010,5,Wolves,9,5,0,5,5
2010,5,Sunderland,10,5,0,4,4
2010,5,Spurs,11,5,0,3,3
2010,5,Bolton,12,5,-1,6,7
2010,5,Liverpool,13,5,-2,2,4
2010,5,Newcastle,14,4,1,7,6
2010,5,Blackburn,15,4,-1,4,5
2010,5,West Brom,16,4,-6,2,8
2010,5,Wigan,17,4,-9,2,11
2010,5,Stoke City,18,3,-3,4,7
2010,5,Everton,19,2,-2,4,6
2010,5,West Ham,20,0,-10,2,12
2010,6,Chelsea,1,15,20,21,1
2010,6,Arsenal,2,11,10,14,4
2010,6,Man Utd,3,11,7,14,7
2010,6,Man City,4,8,4,6,2
2010,6,Spurs,5,8,2,6,4
2010,6,Newcastle,6,7,2,8,6
2010,6,Fulham,7,7,1,7,6
2010,6,Aston Villa,8,7,-3,6,9
2010,6,Blackpool,9,7,-4,8,12
2010,6,West Brom,10,7,-4,5,9
2010,6,Sunderland,11,6,0,5,5
2010,6,Birmingham,12,6,-1,7,8
2010,6,Bolton,13,6,-1,7,8
2010,6,Blackburn,14,5,-1,5,6
2010,6,Wolves,15,5,-2,6,8
2010,6,Liverpool,16,5,-3,4,7
2010,6,Stoke City,17,4,-3,5,8
2010,6,Wigan,18,4,-11,2,13
2010,6,Everton,19,2,-3,4,7
2010,6,West Ham,20,1,-10,3,13
2010,7,Chelsea,1,15,19,21,2
2010,7,Man Utd,2,12,7,16,9
2010,7,Arsenal,3,11,9,16,7
2010,7,Man City,4,11,5,7,2
2010,7,Aston Villa,5,10,-2,8,10
2010,7,West Brom,6,10,-3,8,11
2010,7,Fulham,7,8,1,7,6
2010,7,Spurs,8,8,1,6,5
2010,7,Blackburn,9,8,0,7,7
2010,7,Newcastle,10,7,1,9,8
2010,7,Sunderland,11,7,0,7,7
2010,7,Bolton,12,7,-1,9,10
2010,7,Birmingham,13,7,-1,7,8
2010,7,Stoke City,14,7,-2,7,9
2010,7,Blackpool,15,7,-5,9,14
2010,7,Liverpool,16,6,-3,6,9
2010,7,Wolves,17,5,-3,7,10
2010,7,Wigan,18,5,-11,2,13
2010,7,West Ham,19,4,-9,4,13
2010,7,Everton,20,3,-3,4,7
2010,8,Chelsea,1,18,21,23,2
2010,8,Man City,2,14,6,9,3
2010,8,Man Utd,3,13,7,16,9
2010,8,Arsenal,4,11,7,16,9
2010,8,Spurs,5,11,2,8,6
2010,8,West Brom,6,11,-3,9,12
2010,8,Stoke City,7,10,-1,8,9
2010,8,Aston Villa,8,10,-3,9,12
2010,8,Blackpool,9,10,-4,11,15
2010,8,Fulham,10,9,1,8,7
2010,8,Sunderland,11,8,0,7,7
2010,8,Bolton,12,8,-1,10,11
2010,8,Blackburn,13,8,-1,7,8
2010,8,Wigan,14,8,-9,4,13
2010,8,Newcastle,15,7,0,10,10
2010,8,Birmingham,16,7,-3,7,10
2010,8,Everton,17,6,-1,6,7
2010,8,Liverpool,18,6,-4,7,11
2010,8,Wolves,19,5,-5,7,12
2010,8,West Ham,20,5,-9,5,14
2010,9,Chelsea,1,19,21,23,2
2010,9,Man City,2,17,7,12,5
2010,9,Arsenal,3,14,8,18,10
2010,9,Man Utd,4,14,7,18,11
2010,9,Spurs,5,14,3,10,7
2010,9,West Brom,6,12,-3,11,14
2010,9,Bolton,7,11,0,12,12
2010,9,Aston Villa,8,11,-3,9,12
2010,9,Stoke City,9,10,-2,9,11
2010,9,Blackpool,10,10,-5,13,18
2010,9,Everton,11,9,1,8,7
2010,9,Fulham,12,9,0,9,9
2010,9,Sunderland,13,9,0,7,7
2010,9,Blackburn,14,9,-1,7,8
2010,9,Wigan,15,9,-9,6,15
2010,9,Newcastle,16,8,0,12,12
2010,9,Birmingham,17,7,-4,8,12
2010,9,Wolves,18,6,-5,8,13
2010,9,Liverpool,19,6,-6,7,13
2010,9,West Ham,20,6,-9,6,15
2010,10,Chelsea,1,22,23,25,2
2010,10,Arsenal,2,17,11,21,10
2010,10,Man Utd,3,17,8,20,12
2010,10,Man City,4,17,4,12,8
2010,10,Spurs,5,15,3,11,8
2010,10,West Brom,6,15,-2,13,15
2010,10,Sunderland,7,12,1,8,7
2010,10,Bolton,8,12,0,13,13
2010,10,Newcastle,9,11,1,14,13
2010,10,Aston Villa,10,11,-4,9,13
2010,10,Everton,11,10,1,9,8
2010,10,Birmingham,12,10,-2,10,12
2010,10,Stoke City,13,10,-3,10,13
2010,10,Blackpool,14,10,-7,13,20
2010,10,Wigan,15,10,-9,7,16
2010,10,Fulham,16,9,-1,10,11
2010,10,Blackburn,17,9,-2,8,10
2010,10,Liverpool,18,9,-5,9,14
2010,10,Wolves,19,6,-7,8,15
2010,10,West Ham,20,6,-10,7,17
2010,11,Chelsea,1,25,24,27,3
2010,11,Arsenal,2,20,12,22,10
2010,11,Man Utd,3,20,10,22,12
2010,11,Man City,4,17,3,13,10
2010,11,Spurs,5,15,1,11,10
2010,11,West Brom,6,15,-3,14,17
2010,11,Newcastle,7,14,5,19,14
2010,11,Everton,8,13,2,10,8
2010,11,Blackpool,9,13,-6,15,21
2010,11,Fulham,10,12,1,12,11
2010,11,Bolton,11,12,-1,13,14
2010,11,Sunderland,12,12,-3,9,12
2010,11,Liverpool,13,12,-4,10,14
2010,11,Aston Villa,14,12,-4,9,13
2010,11,Birmingham,15,11,-2,10,12
2010,11,Stoke City,16,10,-4,10,14
2010,11,Wigan,17,10,-11,7,18
2010,11,Blackburn,18,9,-3,9,12
2010,11,Wolves,19,9,-6,10,16
2010,11,West Ham,20,6,-11,7,18
2010,12,Chelsea,1,25,22,27,5
2010,12,Man Utd,2,23,11,24,13
2010,12,Arsenal,3,20,11,22,11
2010,12,Man City,4,20,5,15,10
2010,12,Newcastle,5,17,6,20,14
2010,12,Bolton,6,15,1,17,16
2010,12,Spurs,7,15,-1,13,14
2010,12,Sunderland,8,15,-1,11,12
2010,12,Liverpool,9,15,-2,12,14
2010,12,West Brom,10,15,-5,14,19
2010,12,Everton,11,14,2,12,10
2010,12,Blackpool,12,14,-6,17,23
2010,12,Fulham,13,13,1,13,12
2010,12,Aston Villa,14,13,-4,10,14
2010,12,Birmingham,15,12,-2,12,14
2010,12,Blackburn,16,12,-2,11,13
2010,12,Stoke City,17,10,-6,10,16
2010,12,Wigan,18,10,-12,8,20
2010,12,Wolves,19,9,-7,11,18
2010,12,West Ham,20,7,-11,9,20
2010,13,Chelsea,1,28,23,28,5
2010,13,Man Utd,2,24,11,24,13
2010,13,Arsenal,3,23,13,24,11
2010,13,Man City,4,21,5,15,10
2010,13,Newcastle,5,17,5,21,16
2010,13,Bolton,6,16,1,18,17
2010,13,Spurs,7,16,-1,14,15
2010,13,Sunderland,8,16,-1,12,13
2010,13,Liverpool,9,16,-2,13,15
2010,13,Aston Villa,10,16,-3,13,16
2010,13,West Brom,11,16,-5,16,21
2010,13,Everton,12,15,2,13,11
2010,13,Blackburn,13,15,-1,13,14
2010,13,Blackpool,14,14,-7,19,26
2010,13,Fulham,15,13,0,13,13
2010,13,Stoke City,16,13,-5,13,18
2010,13,Birmingham,17,12,-3,14,17
2010,13,Wigan,18,11,-12,9,21
2010,13,Wolves,19,9,-9,11,20
2010,13,West Ham,20,8,-11,11,22
2010,14,Chelsea,1,28,20,28,8
2010,14,Arsenal,2,26,14,26,12
2010,14,Man Utd,3,25,11,26,15
2010,14,Man City,4,22,5,15,10
2010,14,Bolton,5,19,2,21,19
2010,14,Sunderland,6,19,2,15,13
2010,14,Spurs,7,19,1,18,17
2010,14,Newcastle,8,18,5,21,16
2010,14,Aston Villa,9,17,-3,15,18
2010,14,Stoke City,10,16,-3,15,18
2010,14,Liverpool,11,16,-4,13,17
2010,14,West Brom,12,16,-6,16,22
2010,14,Everton,13,15,1,14,13
2010,14,Blackburn,14,15,-3,15,18
2010,14,Blackpool,15,15,-7,19,26
2010,14,Fulham,16,14,0,13,13
2010,14,Wigan,17,14,-11,10,21
2010,14,Birmingham,18,13,-3,14,17
2010,14,Wolves,19,9,-10,13,23
2010,14,West Ham,20,9,-11,11,22
2010,15,Chelsea,1,28,19,28,9
2010,15,Man Utd,2,28,13,28,15
2010,15,Arsenal,3,26,13,28,15
2010,15,Man City,4,25,8,19,11
2010,15,Bolton,5,22,6,26,20
2010,15,Spurs,6,22,2,21,19
2010,15,Sunderland,7,20,2,17,15
2010,15,Stoke City,8,19,0,18,18
2010,15,Liverpool,9,19,-1,16,17
2010,15,Newcastle,10,18,1,22,21
2010,15,Blackburn,11,18,-1,17,18
2010,15,Blackpool,12,18,-6,21,27
2010,15,Aston Villa,13,17,-5,15,20
2010,15,Everton,14,16,1,16,15
2010,15,Birmingham,15,16,-2,15,17
2010,15,West Brom,16,16,-9,16,25
2010,15,Fulham,17,14,-3,14,17
2010,15,Wigan,18,14,-13,10,23
2010,15,Wolves,19,9,-11,14,25
2010,15,West Ham,20,9,-14,11,25
2010,16,Man Utd,1,31,19,35,16
2010,16,Chelsea,2,29,19,29,10
2010,16,Arsenal,3,29,15,32,17
2010,16,Man City,4,26,8,20,12
2010,16,Spurs,5,25,3,23,20
2010,16,Bolton,6,23,6,28,22
2010,16,Sunderland,7,20,1,19,18
2010,16,Stoke City,8,20,0,19,19
2010,16,Newcastle,9,19,1,23,22
2010,16,Liverpool,10,19,-2,17,19
2010,16,Blackpool,11,19,-6,23,29
2010,16,West Brom,12,19,-6,20,26
2010,16,Blackburn,13,18,-7,18,25
2010,16,Birmingham,14,17,-2,16,18
2010,16,Aston Villa,15,17,-7,17,24
2010,16,Everton,16,16,-2,17,19
2010,16,Fulham,17,15,-3,15,18
2010,16,Wigan,18,14,-15,11,26
2010,16,Wolves,19,12,-10,17,27
2010,16,West Ham,20,12,-12,14,26
2010,17,Man Utd,1,34,20,38,18
2010,17,Arsenal,2,32,16,34,18
2010,17,Chelsea,3,30,19,30,11
2010,17,Man City,4,29,9,21,12
2010,17,Spurs,5,26,3,24,21
2010,17,Bolton,6,23,5,28,23
2010,17,Sunderland,7,23,2,20,18
2010,17,Liverpool,8,22,1,20,19
2010,17,West Brom,9,22,-4,23,27
2010,17,Stoke City,10,21,0,21,21
2010,17,Blackburn,11,21,-4,21,25
2010,17,Newcastle,12,19,-1,24,25
2010,17,Blackpool,13,19,-7,25,32
2010,17,Birmingham,14,18,-2,17,19
2010,17,Everton,15,17,-2,18,20
2010,17,Aston Villa,16,17,-10,17,27
2010,17,Fulham,17,15,-4,16,20
2010,17,Wigan,18,15,-15,13,28
2010,17,Wolves,19,12,-13,17,30
2010,17,West Ham,20,12,-13,14,27
2010,18,Man Utd,1,37,21,39,18
2010,18,Arsenal,2,32,15,34,19
2010,18,Man City,3,32,11,24,13
2010,18,Chelsea,4,31,19,31,12
2010,18,Spurs,5,27,3,25,22
2010,18,Bolton,6,26,6,30,24
2010,18,Sunderland,7,24,2,20,18
2010,18,Newcastle,8,22,1,27,26
2010,18,Liverpool,9,22,-1,21,22
2010,18,West Brom,10,22,-5,24,29
2010,18,Blackpool,11,22,-6,26,32
2010,18,Stoke City,12,21,-1,21,22
2010,18,Blackburn,13,21,-5,22,27
2010,18,Aston Villa,14,20,-9,19,28
2010,18,Everton,15,18,-2,18,20
2010,18,Birmingham,16,18,-3,17,20
2010,18,Fulham,17,16,-4,16,20
2010,18,Wigan,18,16,-15,13,28
2010,18,Wolves,19,15,-12,18,30
2010,18,West Ham,20,12,-15,15,30
2010,19,Man Utd,1,37,20,40,20
2010,19,Arsenal,2,35,16,35,19
2010,19,Chelsea,3,34,20,33,13
2010,19,Man City,4,32,10,25,15
2010,19,Sunderland,5,27,3,21,18
2010,19,Spurs,6,27,1,26,25
2010,19,Bolton,7,26,5,30,25
2010,19,Newcastle,8,25,3,29,26
2010,19,Liverpool,9,25,0,22,22
2010,19,Blackpool,10,25,-4,29,33
2010,19,West Brom,11,23,-5,25,30
2010,19,Aston Villa,12,23,-8,21,29
2010,19,Blackburn,13,22,-5,23,28
2010,19,Everton,14,21,-1,20,21
2010,19,Stoke City,15,21,-2,21,23
2010,19,Birmingham,16,18,-5,17,22
2010,19,Fulham,17,16,-5,16,21
2010,19,Wolves,18,16,-12,19,31
2010,19,Wigan,19,16,-16,14,30
2010,19,West Ham,20,13,-15,16,31
2010,20,Man Utd,1,40,22,42,20
2010,20,Arsenal,2,38,18,38,20
2010,20,Man City,3,35,12,28,16
2010,20,Chelsea,4,34,18,34,16
2010,20,Spurs,5,30,2,28,26
2010,20,Bolton,6,29,7,32,25
2010,20,Blackpool,7,28,-3,31,34
2010,20,Sunderland,8,27,1,21,20
2010,20,Newcastle,9,25,1,30,29
2010,20,Liverpool,10,25,-1,23,24
2010,20,Stoke City,11,24,0,23,23
2010,20,West Brom,12,23,-7,25,32
2010,20,Aston Villa,13,23,-9,22,31
2010,20,Everton,14,22,-1,21,22
2010,20,Blackburn,15,22,-7,23,30
2010,20,Birmingham,16,19,-5,18,23
2010,20,Wigan,17,19,-15,16,31
2010,20,Fulham,18,16,-7,17,24
2010,20,Wolves,19,16,-13,20,33
2010,20,West Ham,20,16,-13,19,32
2010,21,Man Utd,1,41,22,43,21
2010,21,Arsenal,2,39,18,40,22
2010,21,Man City,3,38,16,32,16
2010,21,Chelsea,4,37,19,35,16
2010,21,Spurs,5,33,4,30,26
2010,21,Blackpool,6,31,-1,33,34
2010,21,Bolton,7,29,6,32,26
2010,21,Sunderland,8,27,-1,21,22
2010,21,Newcastle,9,25,-1,30,31
2010,21,Liverpool,10,25,-2,23,25
2010,21,Blackburn,11,25,-5,26,31
2010,21,Stoke City,12,24,-2,23,25
2010,21,Everton,13,23,-1,22,23
2010,21,West Brom,14,23,-9,26,35
2010,21,Aston Villa,15,23,-13,22,35
2010,21,Birmingham,16,20,-5,19,24
2010,21,Wigan,17,20,-15,18,33
2010,21,Fulham,18,19,-5,19,24
2010,21,Wolves,19,19,-12,21,33
2010,21,West Ham,20,17,-13,20,33
2010,22,Man Utd,1,44,23,45,22
2010,22,Arsenal,2,42,21,43,22
2010,22,Man City,3,41,17,33,16
2010,22,Chelsea,4,38,19,38,19
2010,22,Spurs,5,36,5,31,26
2010,22,Blackpool,6,31,-2,33,35
2010,22,Sunderland,7,30,2,24,22
2010,22,Bolton,8,29,5,33,28
2010,22,Newcastle,9,28,0,31,31
2010,22,Liverpool,10,28,-1,25,26
2010,22,Stoke City,11,27,0,25,25
2010,22,Blackburn,12,25,-8,26,34
2010,22,Aston Villa,13,24,-13,25,38
2010,22,Everton,14,23,-3,22,25
2010,22,West Brom,15,23,-10,27,37
2010,22,Birmingham,16,20,-8,19,27
2010,22,West Ham,17,20,-11,22,33
2010,22,Wigan,18,20,-16,18,34
2010,22,Fulham,19,19,-6,19,25
2010,22,Wolves,20,19,-14,21,35
2010,23,Man Utd,1,47,24,47,23
2010,23,Arsenal,2,43,21,43,22
2010,23,Man City,3,42,17,33,16
2010,23,Chelsea,4,38,18,38,20
2010,23,Spurs,5,36,4,32,28
2010,23,Sunderland,6,33,3,25,22
2010,23,Newcastle,7,31,5,36,31
2010,23,Blackpool,8,31,-3,34,37
2010,23,Bolton,9,30,5,34,29
2010,23,Liverpool,10,28,-3,26,29
2010,23,Blackburn,11,28,-6,29,35
2010,23,Stoke City,12,27,-1,26,27
2010,23,Everton,13,26,-2,24,26
2010,23,Aston Villa,14,24,-14,25,39
2010,23,Birmingham,15,23,-7,21,28
2010,23,West Brom,16,23,-13,27,40
2010,23,Fulham,17,22,-3,22,25
2010,23,Wolves,18,22,-13,22,35
2010,23,Wigan,19,21,-16,19,35
2010,23,West Ham,20,20,-16,22,38
2010,24,Man Utd,1,48,24,47,23
2010,24,Arsenal,2,46,24,46,22
2010,24,Man City,3,45,18,37,19
2010,24,Chelsea,4,41,20,40,20
2010,24,Spurs,5,37,4,32,28
2010,24,Sunderland,6,34,3,26,23
2010,24,Newcastle,7,32,5,37,32
2010,24,Blackpool,8,31,-4,36,40
2010,24,Bolton,9,30,3,34,31
2010,24,Stoke City,10,30,1,28,27
2010,24,Liverpool,11,29,-3,28,31
2010,24,Blackburn,12,28,-8,29,37
2010,24,Everton,13,27,-2,26,28
2010,24,West Brom,14,26,-12,30,42
2010,24,Aston Villa,15,25,-14,26,40
2010,24,Birmingham,16,24,-7,22,29
2010,24,Fulham,17,23,-3,23,26
2010,24,Wolves,18,22,-14,25,39
2010,24,Wigan,19,22,-16,20,36
2010,24,West Ham,20,20,-19,22,41
2010,25,Man Utd,1,51,29,52,23
2010,25,Arsenal,2,49,27,49,22
2010,25,Man City,3,45,17,37,20
2010,25,Chelsea,4,44,24,44,20
2010,25,Spurs,5,38,4,33,29
2010,25,Sunderland,6,37,4,28,24
2010,25,Newcastle,7,33,5,38,33
2010,25,Liverpool,8,32,0,31,31
2010,25,Blackpool,9,31,-5,37,42
2010,25,Blackburn,10,31,-6,31,37
2010,25,Bolton,11,30,-1,34,35
2010,25,Stoke City,12,30,-1,28,29
2010,25,Everton,13,28,-2,28,30
2010,25,Aston Villa,14,28,-13,27,40
2010,25,Fulham,15,26,-1,25,26
2010,25,West Brom,16,26,-14,30,44
2010,25,Birmingham,17,24,-12,22,34
2010,25,Wolves,18,22,-17,25,42
2010,25,Wigan,19,22,-19,20,39
2010,25,West Ham,20,21,-19,24,43
2010,26,Man Utd,1,54,31,55,24
2010,26,Arsenal,2,52,28,51,23
2010,26,Chelsea,3,47,26,48,22
2010,26,Man City,4,46,17,39,22
2010,26,Spurs,5,41,5,34,29
2010,26,Sunderland,6,37,2,30,28
2010,26,Liverpool,7,35,2,33,31
2010,26,Newcastle,8,33,4,38,34
2010,26,Bolton,9,33,0,35,35
2010,26,Blackpool,10,31,-7,38,45
2010,26,Blackburn,11,31,-7,31,38
2010,26,Stoke City,12,30,-3,28,31
2010,26,Fulham,13,29,0,26,26
2010,26,Everton,14,28,-3,29,32
2010,26,Aston Villa,15,28,-15,28,43
2010,26,West Brom,16,27,-14,32,46
2010,26,Birmingham,17,25,-12,24,36
2010,26,West Ham,18,24,-17,27,44
2010,26,Wigan,19,23,-19,22,41
2010,26,Wolves,20,22,-18,25,43
2010,27,Man Utd,1,54,30,56,26
2010,27,Arsenal,2,53,28,55,27
2010,27,Man City,3,49,20,42,22
2010,27,Chelsea,4,47,25,48,23
2010,27,Spurs,5,44,6,36,30
2010,27,Liverpool,6,38,3,34,31
2010,27,Sunderland,7,37,1,32,31
2010,27,Newcastle,8,34,4,42,38
2010,27,Bolton,9,33,-1,36,37
2010,27,Stoke City,10,33,-2,31,33
2010,27,Everton,11,31,-1,34,35
2010,27,Blackburn,12,31,-8,34,42
2010,27,Blackpool,13,31,-9,41,50
2010,27,Fulham,14,30,0,28,28
2010,27,Aston Villa,15,29,-15,30,45
2010,27,Birmingham,16,28,-11,25,36
2010,27,West Brom,17,27,-17,32,49
2010,27,Wigan,18,26,-18,26,44
2010,27,Wolves,19,25,-17,27,44
2010,27,West Ham,20,24,-18,27,45
2010,28,Man Utd,1,57,31,58,27
2010,28,Arsenal,2,56,30,57,27
2010,28,Man City,3,49,19,43,24
2010,28,Chelsea,4,48,25,48,23
2010,28,Spurs,5,47,7,38,31
2010,28,Liverpool,6,39,3,35,32
2010,28,Sunderland,7,37,0,33,33
2010,28,Bolton,8,36,1,38,37
2010,28,Newcastle,9,35,4,42,38
2010,28,Stoke City,10,33,-3,31,34
2010,28,Blackburn,11,32,-8,34,42
2010,28,Blackpool,12,32,-9,42,51
2010,28,Fulham,13,31,0,28,28
2010,28,Everton,14,31,-3,34,37
2010,28,Birmingham,15,31,-10,26,36
2010,28,Aston Villa,16,30,-15,31,46
2010,28,West Brom,17,28,-17,35,52
2010,28,Wigan,18,27,-18,27,45
2010,28,West Ham,19,25,-18,30,48
2010,28,Wolves,20,25,-19,27,46
2010,29,Man Utd,1,60,35,62,27
2010,29,Arsenal,2,57,30,60,30
2010,29,Chelsea,3,51,27,51,24
2010,29,Man City,4,50,19,44,25
2010,29,Spurs,5,48,7,41,34
2010,29,Liverpool,6,39,1,36,35
2010,29,Bolton,7,37,1,39,38
2010,29,Sunderland,8,37,-2,33,35
2010,29,Newcastle,9,36,4,43,39
2010,29,Everton,10,34,-1,36,37
2010,29,Stoke City,11,34,-3,32,35
2010,29,Aston Villa,12,33,-12,35,47
2010,29,Fulham,13,32,0,29,29
2010,29,Blackburn,14,32,-11,35,46
2010,29,Blackpool,15,32,-13,42,55
2010,29,Birmingham,16,31,-12,27,39
2010,29,West Brom,17,29,-17,36,53
2010,29,Wolves,18,28,-15,31,46
2010,29,West Ham,19,28,-16,33,49
2010,29,Wigan,20,27,-22,27,49
2010,30,Man Utd,1,60,33,63,30
2010,30,Arsenal,2,58,30,60,30
2010,30,Chelsea,3,54,29,54,25
2010,30,Man City,4,53,20,45,25
2010,30,Spurs,5,49,7,44,37
2010,30,Liverpool,6,42,3,39,36
2010,30,Bolton,7,40,2,42,40
2010,30,Sunderland,8,38,-2,33,35
2010,30,Everton,9,37,0,38,38
2010,30,Newcastle,10,36,3,44,41
2010,30,Fulham,11,35,1,32,31
2010,30,Stoke City,12,34,-6,32,38
2010,30,Aston Villa,13,33,-13,37,50
2010,30,Blackburn,14,32,-12,37,49
2010,30,Blackpool,15,32,-15,43,58
2010,30,West Brom,16,32,-15,39,54
2010,30,West Ham,17,31,-13,36,49
2010,30,Birmingham,18,31,-14,28,42
2010,30,Wolves,19,29,-15,34,49
2010,30,Wigan,20,27,-23,27,50
2010,31,Man Utd,1,63,34,64,30
2010,31,Arsenal,2,59,30,62,32
2010,31,Chelsea,3,57,31,56,25
2010,31,Man City,4,53,18,45,27
2010,31,Spurs,5,50,7,44,37
2010,31,Liverpool,6,45,5,41,36
2010,31,Bolton,7,40,1,42,41
2010,31,Everton,8,40,1,40,39
2010,31,Sunderland,9,38,-4,33,37
2010,31,Stoke City,10,37,-2,36,38
2010,31,Newcastle,11,36,-1,44,45
2010,31,Fulham,12,35,0,33,33
2010,31,Blackburn,13,33,-12,39,51
2010,31,Aston Villa,14,33,-14,37,51
2010,31,Blackpool,15,33,-15,45,60
2010,31,West Brom,16,33,-15,41,56
2010,31,West Ham,17,32,-13,36,49
2010,31,Wolves,18,32,-14,35,49
2010,31,Birmingham,19,31,-15,29,44
2010,31,Wigan,20,30,-22,29,51
2010,32,Man Utd,1,66,36,68,32
2010,32,Arsenal,2,60,30,62,32
2010,32,Chelsea,3,58,31,57,26
2010,32,Man City,4,56,23,50,27
2010,32,Spurs,5,51,7,44,37
2010,32,Liverpool,6,45,4,42,38
2010,32,Everton,7,41,1,42,41
2010,32,Bolton,8,40,0,43,43
2010,32,Newcastle,9,39,2,48,46
2010,32,Fulham,10,38,3,36,33
2010,32,Stoke City,11,38,-2,37,39
2010,32,Sunderland,12,38,-9,33,42
2010,32,West Brom,13,36,-14,43,57
2010,32,Blackburn,14,34,-12,39,51
2010,32,Aston Villa,15,34,-14,39,53
2010,32,Birmingham,16,34,-14,31,45
2010,32,Blackpool,17,33,-18,45,63
2010,32,West Ham,18,32,-15,38,53
2010,32,Wolves,19,32,-17,36,53
2010,32,Wigan,20,31,-22,29,51
2010,33,Man Utd,1,69,38,70,32
2010,33,Arsenal,2,63,32,65,33
2010,33,Chelsea,3,61,32,58,26
2010,33,Man City,4,56,20,50,30
2010,33,Spurs,5,54,8,47,39
2010,33,Liverpool,6,48,7,45,38
2010,33,Everton,7,44,4,45,41
2010,33,Bolton,8,43,3,46,43
2010,33,Newcastle,9,39,1,48,47
2010,33,West Brom,10,39,-13,46,59
2010,33,Fulham,11,38,1,36,35
2010,33,Stoke City,12,38,-3,39,42
2010,33,Sunderland,13,38,-10,35,45
2010,33,Aston Villa,14,37,-13,40,53
2010,33,Blackburn,15,35,-12,40,52
2010,33,Birmingham,16,35,-14,32,46
2010,33,Blackpool,17,33,-20,46,66
2010,33,West Ham,18,32,-18,38,56
2010,33,Wolves,19,32,-20,36,56
2010,33,Wigan,20,31,-23,29,52
2010,34,Man Utd,1,70,38,70,32
2010,34,Chelsea,2,64,34,61,27
2010,34,Arsenal,3,64,32,66,34
2010,34,Man City,4,59,21,51,30
2010,34,Spurs,5,54,7,47,40
2010,34,Liverpool,6,49,7,46,39
2010,34,Everton,7,47,6,47,41
2010,34,Bolton,8,43,0,46,46
2010,34,Fulham,9,41,4,39,35
2010,34,Stoke City,10,41,0,42,42
2010,34,Newcastle,11,40,1,48,47
2010,34,Aston Villa,12,40,-12,42,54
2010,34,West Brom,13,39,-15,47,62
2010,34,Sunderland,14,38,-12,35,47
2010,34,Birmingham,15,38,-12,34,46
2010,34,Blackburn,16,35,-14,40,54
2010,34,Wigan,17,34,-21,32,53
2010,34,Blackpool,18,33,-22,47,69
2010,34,West Ham,19,32,-19,39,58
2010,34,Wolves,20,32,-23,36,59
2010,35,Man Utd,1,73,39,71,32
2010,35,Chelsea,2,67,37,64,27
2010,35,Arsenal,3,64,31,67,36
2010,35,Man City,4,62,22,52,30
2010,35,Spurs,5,55,7,49,42
2010,35,Liverpool,6,52,12,51,39
2010,35,Everton,7,47,5,47,42
2010,35,Bolton,8,46,1,48,47
2010,35,Fulham,9,42,4,40,36
2010,35,Stoke City,10,42,0,43,43
2010,35,Newcastle,11,41,1,49,48
2010,35,Sunderland,12,41,-10,39,49
2010,35,Aston Villa,13,41,-12,43,55
2010,35,West Brom,14,40,-15,49,64
2010,35,Birmingham,15,38,-17,34,51
2010,35,Blackburn,16,35,-15,40,55
2010,35,Blackpool,17,34,-22,48,70
2010,35,Wigan,18,34,-23,34,57
2010,35,Wolves,19,33,-23,37,60
2010,35,West Ham,20,32,-22,39,61
2010,36,Man Utd,1,73,38,71,33
2010,36,Chelsea,2,70,38,66,28
2010,36,Arsenal,3,67,32,68,36
2010,36,Man City,4,65,23,54,31
2010,36,Liverpool,5,55,15,54,39
2010,36,Spurs,6,55,6,50,44
2010,36,Everton,7,48,5,48,43
2010,36,Bolton,8,46,0,48,48
2010,36,Fulham,9,45,7,43,36
2010,36,Stoke City,10,43,0,43,43
2010,36,West Brom,11,43,-14,51,65
2010,36,Newcastle,12,41,-2,49,51
2010,36,Aston Villa,13,41,-13,44,57
2010,36,Sunderland,14,41,-13,39,52
2010,36,Birmingham,15,39,-17,35,52
2010,36,Blackburn,16,38,-14,41,55
2010,36,Blackpool,17,35,-22,48,70
2010,36,Wigan,18,35,-23,35,58
2010,36,Wolves,19,34,-23,38,61
2010,36,West Ham,20,32,-23,40,63
2010,37,Man Utd,1,76,39,73,34
2010,37,Chelsea,2,70,37,67,30
2010,37,Arsenal,3,67,30,69,39
2010,37,Man City,4,65,22,55,33
2010,37,Liverpool,5,58,18,59,41
2010,37,Spurs,6,56,6,51,45
2010,37,Everton,7,51,6,50,44
2010,37,Stoke City,8,46,2,46,44
2010,37,Bolton,9,46,-1,49,50
2010,37,Fulham,10,45,4,45,41
2010,37,Newcastle,11,44,-1,51,52
2010,37,Sunderland,12,44,-12,41,53
2010,37,West Brom,13,43,-16,52,68
2010,37,Aston Villa,14,42,-13,45,58
2010,37,Blackburn,15,39,-14,42,56
2010,37,Birmingham,16,39,-18,36,54
2010,37,Wolves,17,37,-21,41,62
2010,37,Blackpool,18,36,-22,49,71
2010,37,Wigan,19,36,-23,36,59
2010,37,West Ham,20,33,-23,41,64
2010,38,Man Utd,1,77,39,74,35
2010,38,Chelsea,2,71,37,69,32
2010,38,Man City,3,68,25,58,33
2010,38,Arsenal,4,67,29,70,41
2010,38,Spurs,5,59,8,53,45
2010,38,Liverpool,6,58,16,59,43
2010,38,Everton,7,51,5,50,45
2010,38,Fulham,8,48,6,47,41
2010,38,Stoke City,9,46,-1,46,47
2010,38,Bolton,10,46,-2,52,54
2010,38,West Brom,11,46,-15,53,68
2010,38,Newcastle,12,45,-1,53,54
2010,38,Aston Villa,13,45,-12,47,59
2010,38,Sunderland,14,44,-14,42,56
2010,38,Blackburn,15,40,-14,43,57
2010,38,Wolves,16,40,-19,44,63
2010,38,Birmingham,17,39,-20,36,56
2010,38,Blackpool,18,39,-21,53,74
2010,38,Wigan,19,39,-22,39,61
2010,38,West Ham,20,33,-24,43,67
2010,39,Man Utd,1,80,41,78,37
2010,39,Chelsea,2,71,36,69,33
2010,39,Man City,3,71,27,60,33
2010,39,Arsenal,4,68,29,72,43
2010,39,Spurs,5,62,9,55,46
2010,39,Liverpool,6,58,15,59,44
2010,39,Everton,7,54,6,51,45
2010,39,Fulham,8,49,6,49,43
2010,39,Aston Villa,9,48,-11,48,59
2010,39,Sunderland,10,47,-11,45,56
2010,39,West Brom,11,47,-15,56,71
2010,39,Newcastle,12,46,-1,56,57
2010,39,Stoke City,13,46,-2,46,48
2010,39,Bolton,14,46,-4,52,56
2010,39,Blackburn,15,43,-13,46,59
2010,39,Wigan,16,42,-21,40,61
2010,39,Wolves,17,40,-20,46,66
2010,39,Birmingham,18,39,-21,37,58
2010,39,Blackpool,19,39,-23,55,78
2010,39,West Ham,20,33,-27,43,70
