match_year,match_round,team,team_rank,team_points,team_goal_difference,team_goal_fatti,team_goal_subiti
2011,2,SSC Napoli,1,3,5,6,1
2011,2,Inter,2,3,3,4,1
2011,2,AS Roma,3,3,2,2,0
2011,2,AC Milan,4,3,2,2,0
2011,2,Parma,5,1,0,3,3
2011,2,Catania,6,1,0,3,3
2011,2,US Palermo,7,1,0,2,2
2011,2,Novara,8,1,0,2,2
2011,2,Lazio,9,1,0,0,0
2011,2,Udinese Calcio,10,1,0,0,0
2011,2,Fiorentina,11,1,0,0,0
2011,2,Juventus,12,1,0,0,0
2011,2,Chievo Verona,13,1,0,0,0
2011,2,Siena,14,1,0,0,0
2011,2,Bologna,15,0,-2,0,2
2011,2,Cagliari Calcio,16,0,-2,0,2
2011,2,Lecce,17,0,-3,1,4
2011,2,Cesena,18,0,-3,1,4
2011,2,Genoa,19,0,-5,1,6
2011,2,Atalanta,20,-3,3,4,1
2011,3,SSC Napoli,1,6,7,9,2
2011,3,Juventus,2,4,3,4,1
2011,3,AC Milan,3,4,2,4,2
2011,3,Udinese Calcio,4,4,2,2,0
2011,3,Fiorentina,5,4,2,2,0
2011,3,US Palermo,6,4,1,6,5
2011,3,Inter,7,3,2,7,5
2011,3,AS Roma,8,3,1,3,2
2011,3,Cagliari Calcio,9,3,-1,2,3
2011,3,Novara,10,2,0,4,4
2011,3,Catania,11,2,0,3,3
2011,3,Lazio,12,2,0,2,2
2011,3,Chievo Verona,13,2,0,2,2
2011,3,Siena,14,2,0,0,0
2011,3,Parma,15,1,-3,4,7
2011,3,Genoa,16,1,-5,3,8
2011,3,Bologna,17,0,-4,0,4
2011,3,Cesena,18,0,-5,2,7
2011,3,Lecce,19,0,-5,1,6
2011,3,Atalanta,20,-2,3,6,3
2011,4,SSC Napoli,1,9,9,12,3
2011,4,Juventus,2,7,4,5,1
2011,4,Udinese Calcio,3,7,4,4,0
2011,4,Cagliari Calcio,4,6,0,4,4
2011,4,Catania,5,5,1,4,3
2011,4,Inter,6,4,2,7,5
2011,4,AS Roma,7,4,1,3,2
2011,4,US Palermo,8,4,0,6,6
2011,4,AC Milan,9,4,0,5,5
2011,4,Fiorentina,10,4,0,2,2
2011,4,Parma,11,4,-2,6,8
2011,4,Genoa,12,4,-4,5,9
2011,4,Lecce,13,3,-3,3,6
2011,4,Novara,14,2,-1,5,6
2011,4,Lazio,15,2,-1,3,4
2011,4,Chievo Verona,16,2,-1,3,4
2011,4,Siena,17,2,-1,0,1
2011,4,Atalanta,18,1,4,7,3
2011,4,Cesena,19,0,-6,2,8
2011,4,Bologna,20,0,-6,0,6
2011,5,SSC Napoli,1,9,8,12,4
2011,5,Juventus,2,8,4,6,2
2011,5,Udinese Calcio,3,8,4,5,1
2011,5,Fiorentina,4,7,3,5,2
2011,5,US Palermo,5,7,1,9,8
2011,5,Genoa,6,7,-1,8,9
2011,5,Cagliari Calcio,7,6,-1,6,7
2011,5,Novara,8,5,1,8,7
2011,5,AS Roma,9,5,1,4,3
2011,5,AC Milan,10,5,0,6,6
2011,5,Lazio,11,5,0,5,5
2011,5,Chievo Verona,12,5,0,4,4
2011,5,Catania,13,5,-2,4,6
2011,5,Atalanta,14,4,5,9,4
2011,5,Inter,15,4,0,8,8
2011,5,Parma,16,4,-5,6,11
2011,5,Siena,17,3,-1,1,2
2011,5,Lecce,18,3,-4,4,8
2011,5,Bologna,19,1,-6,1,7
2011,5,Cesena,20,0,-7,3,10
2011,6,SSC Napoli,1,10,8,12,4
2011,6,Juventus,2,9,4,7,3
2011,6,Udinese Calcio,3,9,4,5,1
2011,6,Fiorentina,4,8,3,5,2
2011,6,AS Roma,5,8,2,5,3
2011,6,US Palermo,6,8,1,9,8
2011,6,AC Milan,7,8,1,7,6
2011,6,Chievo Verona,8,8,1,6,5
2011,6,Atalanta,9,7,6,11,5
2011,6,Inter,10,7,2,11,9
2011,6,Cagliari Calcio,11,7,-1,6,7
2011,6,Genoa,12,7,-2,9,11
2011,6,Siena,13,6,2,4,2
2011,6,Lazio,14,6,0,5,5
2011,6,Catania,15,6,-2,5,7
2011,6,Novara,16,5,0,9,9
2011,6,Parma,17,4,-6,6,12
2011,6,Lecce,18,3,-7,4,11
2011,6,Bologna,19,1,-8,2,10
2011,6,Cesena,20,0,-8,3,11
2011,7,SSC Napoli,1,13,11,15,4
2011,7,Juventus,2,12,6,9,3
2011,7,Udinese Calcio,3,12,6,7,1
2011,7,AS Roma,4,11,4,8,4
2011,7,US Palermo,5,11,3,11,8
2011,7,Cagliari Calcio,6,10,1,8,7
2011,7,Lazio,7,9,1,7,6
2011,7,Chievo Verona,8,9,1,6,5
2011,7,Fiorentina,9,8,2,6,4
2011,7,AC Milan,10,8,-1,7,8
2011,7,Atalanta,11,7,4,12,8
2011,7,Inter,12,7,-1,11,12
2011,7,Catania,13,7,-2,8,10
2011,7,Genoa,14,7,-4,10,14
2011,7,Parma,15,7,-4,9,13
2011,7,Novara,16,6,0,12,12
2011,7,Siena,17,6,0,4,4
2011,7,Lecce,18,3,-9,4,13
2011,7,Cesena,19,1,-8,3,11
2011,7,Bologna,20,1,-10,2,12
2011,8,SSC Napoli,1,13,10,16,6
2011,8,Juventus,2,13,6,9,3
2011,8,Udinese Calcio,3,13,6,7,1
2011,8,Lazio,4,12,2,9,7
2011,8,AS Roma,5,11,3,9,6
2011,8,AC Milan,6,11,2,10,8
2011,8,Cagliari Calcio,7,11,1,8,7
2011,8,US Palermo,8,11,0,11,11
2011,8,Chievo Verona,9,10,1,6,5
2011,8,Catania,10,10,-1,10,11
2011,8,Parma,11,10,-3,11,14
2011,8,Fiorentina,12,9,2,6,4
2011,8,Atalanta,13,8,4,12,8
2011,8,Genoa,14,8,-4,10,14
2011,8,Siena,15,7,0,4,4
2011,8,Inter,16,7,-2,12,14
2011,8,Novara,17,6,-2,12,14
2011,8,Bologna,18,4,-8,4,12
2011,8,Lecce,19,4,-9,4,13
2011,8,Cesena,20,2,-8,3,11
2011,9,Udinese Calcio,1,16,9,10,1
2011,9,Lazio,2,15,4,11,7
2011,9,SSC Napoli,3,14,10,16,6
2011,9,Juventus,4,14,6,11,5
2011,9,AS Roma,5,14,4,10,6
2011,9,AC Milan,6,14,3,14,11
2011,9,Cagliari Calcio,7,12,1,8,7
2011,9,Atalanta,8,11,5,14,9
2011,9,Catania,9,11,-1,12,13
2011,9,US Palermo,10,11,-1,11,12
2011,9,Fiorentina,11,10,2,8,6
2011,9,Siena,12,10,2,6,4
2011,9,Chievo Verona,13,10,0,6,6
2011,9,Inter,14,10,-1,13,14
2011,9,Parma,15,10,-4,12,16
2011,9,Genoa,16,9,-4,12,16
2011,9,Novara,17,6,-5,12,17
2011,9,Lecce,18,4,-10,7,17
2011,9,Bologna,19,4,-10,4,14
2011,9,Cesena,20,2,-10,3,13
2011,10,SSC Napoli,1,17,12,18,6
2011,10,Juventus,2,17,7,13,6
2011,10,AC Milan,3,17,6,18,12
2011,10,Udinese Calcio,4,16,7,10,3
2011,10,Lazio,5,16,4,12,8
2011,10,AS Roma,6,14,3,11,8
2011,10,US Palermo,7,14,1,13,12
2011,10,Cagliari Calcio,8,13,1,9,8
2011,10,Atalanta,9,12,5,15,10
2011,10,Catania,10,12,-1,13,14
2011,10,Genoa,11,12,-3,14,17
2011,10,Siena,12,11,2,7,5
2011,10,Inter,13,11,-1,14,15
2011,10,Fiorentina,14,10,1,9,8
2011,10,Chievo Verona,15,10,-1,6,7
2011,10,Parma,16,10,-7,13,20
2011,10,Novara,17,7,-5,13,18
2011,10,Bologna,18,7,-9,5,14
2011,10,Lecce,19,4,-12,7,19
2011,10,Cesena,20,3,-10,4,14
2011,11,Juventus,1,20,8,15,7
2011,11,AC Milan,2,20,7,21,14
2011,11,Udinese Calcio,3,19,8,11,3
2011,11,Lazio,4,19,7,15,8
2011,11,SSC Napoli,5,17,11,19,8
2011,11,Catania,6,15,0,15,15
2011,11,Siena,7,14,5,11,6
2011,11,AS Roma,8,14,2,13,11
2011,11,US Palermo,9,14,0,13,13
2011,11,Fiorentina,10,13,2,10,8
2011,11,Cagliari Calcio,11,13,-2,9,11
2011,11,Parma,12,13,-5,15,20
2011,11,Atalanta,13,12,3,16,13
2011,11,Genoa,14,12,-4,14,18
2011,11,Inter,15,11,-2,15,17
2011,11,Chievo Verona,16,10,-4,7,11
2011,11,Bologna,17,10,-7,8,15
2011,11,Novara,18,8,-5,14,19
2011,11,Lecce,19,5,-12,8,20
2011,11,Cesena,20,3,-12,4,16
2011,12,AC Milan,1,23,11,25,14
2011,12,Udinese Calcio,2,22,9,13,4
2011,12,Lazio,3,22,8,16,8
2011,12,Juventus,4,21,8,18,10
2011,12,SSC Napoli,5,18,11,22,11
2011,12,AS Roma,6,17,4,15,11
2011,12,US Palermo,7,17,2,16,14
2011,12,Atalanta,8,15,4,17,13
2011,12,Catania,9,15,-4,15,19
2011,12,Siena,10,14,4,12,8
2011,12,Inter,11,14,-1,16,17
2011,12,Fiorentina,12,13,1,10,9
2011,12,Cagliari Calcio,13,13,-3,9,12
2011,12,Chievo Verona,14,13,-3,8,11
2011,12,Parma,15,13,-6,15,21
2011,12,Genoa,16,12,-5,14,19
2011,12,Bologna,17,10,-9,9,18
2011,12,Novara,18,8,-7,14,21
2011,12,Lecce,19,8,-11,9,20
2011,12,Cesena,20,3,-13,4,17
2011,13,AC Milan,1,24,11,25,14
2011,13,Juventus,2,24,11,21,10
2011,13,Lazio,3,23,8,16,8
2011,13,Udinese Calcio,4,22,7,13,6
2011,13,AS Roma,5,20,5,17,12
2011,13,SSC Napoli,6,19,11,22,11
2011,13,Inter,7,17,0,18,18
2011,13,US Palermo,8,17,-1,16,17
2011,13,Atalanta,9,16,4,19,15
2011,13,Chievo Verona,10,16,-2,10,12
2011,13,Parma,11,16,-4,17,21
2011,13,Siena,12,15,4,14,10
2011,13,Genoa,13,15,-4,15,19
2011,13,Catania,14,15,-5,16,21
2011,13,Fiorentina,15,14,1,10,9
2011,13,Cagliari Calcio,16,13,-4,10,14
2011,13,Bologna,17,10,-10,9,19
2011,13,Novara,18,8,-8,14,22
2011,13,Lecce,19,8,-12,10,22
2011,13,Cesena,20,6,-12,5,17
2011,14,AC Milan,1,27,15,29,14
2011,14,Juventus,2,27,12,22,10
2011,14,Udinese Calcio,3,25,9,15,6
2011,14,Lazio,4,23,7,16,9
2011,14,SSC Napoli,5,20,11,23,12
2011,14,AS Roma,6,20,3,17,14
2011,14,Inter,7,20,1,19,18
2011,14,US Palermo,8,20,1,18,17
2011,14,Catania,9,18,-4,17,21
2011,14,Atalanta,10,17,4,20,16
2011,14,Parma,11,16,-5,18,23
2011,14,Chievo Verona,12,16,-6,10,16
2011,14,Siena,13,15,3,14,11
2011,14,Genoa,14,15,-6,15,21
2011,14,Fiorentina,15,14,-1,10,11
2011,14,Cagliari Calcio,16,14,-4,11,15
2011,14,Novara,17,11,-7,16,23
2011,14,Bologna,18,11,-10,10,20
2011,14,Cesena,19,9,-10,7,17
2011,14,Lecce,20,8,-13,10,23
2011,15,AC Milan,1,30,17,31,14
2011,15,Juventus,2,30,14,24,10
2011,15,Udinese Calcio,3,28,10,16,6
2011,15,Lazio,4,26,10,19,9
2011,15,SSC Napoli,5,23,13,27,14
2011,15,US Palermo,6,21,1,18,17
2011,15,Inter,7,20,0,19,19
2011,15,AS Roma,8,20,0,17,17
2011,15,Atalanta,9,18,4,20,16
2011,15,Catania,10,18,-5,17,22
2011,15,Fiorentina,11,17,2,13,11
2011,15,Cagliari Calcio,12,17,-3,12,15
2011,15,Parma,13,17,-5,18,23
2011,15,Chievo Verona,14,17,-6,10,16
2011,15,Siena,15,15,2,14,12
2011,15,Genoa,16,15,-8,15,23
2011,15,Bologna,17,14,-9,11,20
2011,15,Novara,18,11,-10,16,26
2011,15,Cesena,19,9,-12,7,19
2011,15,Lecce,20,8,-15,12,27
2011,16,AC Milan,1,31,17,33,16
2011,16,Juventus,2,31,14,25,11
2011,16,Udinese Calcio,3,31,11,18,7
2011,16,Lazio,4,29,11,22,11
2011,16,SSC Napoli,5,24,13,28,15
2011,16,Inter,6,23,2,21,19
2011,16,AS Roma,7,21,0,18,18
2011,16,US Palermo,8,21,0,18,18
2011,16,Atalanta,9,19,4,21,17
2011,16,Catania,10,19,-5,18,23
2011,16,Cagliari Calcio,11,18,-3,12,15
2011,16,Parma,12,18,-5,18,23
2011,16,Genoa,13,18,-6,17,23
2011,16,Fiorentina,14,17,0,13,13
2011,16,Chievo Verona,15,17,-7,11,18
2011,16,Siena,16,15,0,14,14
2011,16,Bologna,17,15,-9,13,22
2011,16,Novara,18,12,-10,17,27
2011,16,Cesena,19,12,-11,8,19
2011,16,Lecce,20,8,-16,14,30
2011,17,AC Milan,1,34,19,35,16
2011,17,Juventus,2,34,16,27,11
2011,17,Udinese Calcio,3,32,11,20,9
2011,17,Lazio,4,30,11,24,13
2011,17,Inter,5,26,3,22,19
2011,17,SSC Napoli,6,24,11,29,18
2011,17,AS Roma,7,24,2,21,19
2011,17,Catania,8,22,-3,20,23
2011,17,US Palermo,9,21,-2,18,20
2011,17,Genoa,10,21,-5,19,24
2011,17,Atalanta,11,20,4,23,19
2011,17,Chievo Verona,12,20,-5,13,18
2011,17,Parma,13,19,-5,21,26
2011,17,Fiorentina,14,18,0,15,15
2011,17,Cagliari Calcio,15,18,-5,12,17
2011,17,Siena,16,15,-2,14,16
2011,17,Bologna,17,15,-10,14,24
2011,17,Novara,18,12,-12,17,29
2011,17,Cesena,19,12,-12,8,20
2011,17,Lecce,20,9,-16,17,33
2011,18,AC Milan,1,37,21,37,16
2011,18,Juventus,2,37,17,28,11
2011,18,Udinese Calcio,3,35,14,24,10
2011,18,Lazio,4,30,7,24,17
2011,18,Inter,5,29,8,27,19
2011,18,SSC Napoli,6,27,13,32,19
2011,18,AS Roma,7,27,4,23,19
2011,18,Catania,8,22,-5,20,25
2011,18,Fiorentina,9,21,3,18,15
2011,18,Cagliari Calcio,10,21,-2,15,17
2011,18,US Palermo,11,21,-4,19,23
2011,18,Genoa,12,21,-8,19,27
2011,18,Atalanta,13,20,2,23,21
2011,18,Chievo Verona,14,20,-7,13,20
2011,18,Parma,15,19,-10,21,31
2011,18,Siena,16,18,2,18,16
2011,18,Bologna,17,18,-8,16,24
2011,18,Novara,18,12,-15,17,32
2011,18,Cesena,19,12,-15,9,24
2011,18,Lecce,20,9,-17,17,34
2011,19,Juventus,1,38,17,29,12
2011,19,AC Milan,2,37,20,37,17
2011,19,Udinese Calcio,3,35,13,26,13
2011,19,Lazio,4,33,9,26,17
2011,19,Inter,5,32,9,28,19
2011,19,SSC Napoli,6,28,13,33,20
2011,19,AS Roma,7,28,4,24,20
2011,19,Genoa,8,24,-7,22,29
2011,19,Catania,9,23,-5,21,26
2011,19,Chievo Verona,10,23,-6,14,20
2011,19,Cagliari Calcio,11,22,-2,16,18
2011,19,Parma,12,22,-8,24,32
2011,19,Fiorentina,13,21,2,18,16
2011,19,US Palermo,14,21,-5,19,24
2011,19,Atalanta,15,20,0,23,23
2011,19,Bologna,16,19,-8,17,25
2011,19,Siena,17,18,0,19,19
2011,19,Cesena,18,15,-13,12,25
2011,19,Lecce,19,12,-16,18,34
2011,19,Novara,20,12,-17,18,35
2011,20,Juventus,1,41,19,31,12
2011,20,AC Milan,2,40,23,40,17
2011,20,Udinese Calcio,3,38,14,28,14
2011,20,Inter,4,35,10,30,20
2011,20,Lazio,5,33,8,27,19
2011,20,AS Roma,6,31,8,29,21
2011,20,SSC Napoli,7,29,13,34,21
2011,20,US Palermo,8,24,-3,24,27
2011,20,Chievo Verona,9,24,-6,16,22
2011,20,Genoa,10,24,-9,25,34
2011,20,Cagliari Calcio,11,23,-2,16,18
2011,20,Catania,12,23,-6,22,28
2011,20,Parma,13,23,-8,24,32
2011,20,Fiorentina,14,22,2,18,16
2011,20,Atalanta,15,20,-2,23,25
2011,20,Bologna,16,20,-8,17,25
2011,20,Siena,17,19,0,20,20
2011,20,Cesena,18,15,-17,13,30
2011,20,Lecce,19,13,-16,20,36
2011,20,Novara,20,12,-20,18,38
2011,21,Juventus,1,44,20,33,13
2011,21,AC Milan,2,43,26,43,17
2011,21,Udinese Calcio,3,38,13,29,16
2011,21,Lazio,4,36,11,30,19
2011,21,Inter,5,35,9,30,21
2011,21,AS Roma,6,32,8,30,22
2011,21,SSC Napoli,7,29,12,36,24
2011,21,US Palermo,8,27,-1,26,27
2011,21,Genoa,9,27,-8,28,36
2011,21,Fiorentina,10,25,3,20,17
2011,21,Catania,11,24,-6,23,29
2011,21,Parma,12,24,-8,25,33
2011,21,Chievo Verona,13,24,-9,16,25
2011,21,Atalanta,14,23,-1,24,25
2011,21,Cagliari Calcio,15,23,-5,16,21
2011,21,Bologna,16,21,-8,18,26
2011,21,Siena,17,19,-1,21,22
2011,21,Lecce,18,16,-15,21,36
2011,21,Cesena,19,15,-18,13,31
2011,21,Novara,20,12,-22,18,40
2011,22,Juventus,1,45,20,33,13
2011,22,AC Milan,2,43,24,43,19
2011,22,Udinese Calcio,3,41,14,31,17
2011,22,Lazio,4,39,13,32,19
2011,22,Inter,5,36,9,34,25
2011,22,AS Roma,6,32,6,32,26
2011,22,SSC Napoli,7,30,12,36,24
2011,22,US Palermo,8,28,-1,30,31
2011,22,Catania,9,27,-5,24,29
2011,22,Chievo Verona,10,27,-8,18,26
2011,22,Genoa,11,27,-9,28,37
2011,22,Atalanta,12,26,0,25,25
2011,22,Cagliari Calcio,13,26,-3,20,23
2011,22,Fiorentina,14,25,1,20,19
2011,22,Parma,15,25,-8,25,33
2011,22,Bologna,16,24,-6,20,26
2011,22,Siena,17,19,-2,21,23
2011,22,Lecce,18,16,-16,22,38
2011,22,Cesena,19,16,-18,13,31
2011,22,Novara,20,12,-23,19,42
2011,23,Juventus,1,46,20,33,13
2011,23,AC Milan,2,44,24,43,19
2011,23,Udinese Calcio,3,41,13,33,20
2011,23,Lazio,4,39,12,34,22
2011,23,Inter,5,36,5,34,29
2011,23,AS Roma,6,35,10,36,26
2011,23,SSC Napoli,7,31,12,36,24
2011,23,US Palermo,8,31,0,32,32
2011,23,Genoa,9,30,-8,31,39
2011,23,Fiorentina,10,28,2,23,21
2011,23,Catania,11,28,-5,24,29
2011,23,Parma,12,28,-7,27,34
2011,23,Cagliari Calcio,13,27,-3,20,23
2011,23,Chievo Verona,14,27,-9,19,28
2011,23,Atalanta,15,26,-1,26,27
2011,23,Bologna,16,25,-6,20,26
2011,23,Siena,17,20,-2,21,23
2011,23,Lecce,18,17,-16,22,38
2011,23,Cesena,19,17,-18,13,31
2011,23,Novara,20,13,-23,19,42
2011,24,AC Milan,1,47,25,45,20
2011,24,Juventus,2,47,20,34,14
2011,24,Lazio,3,42,13,37,24
2011,24,Udinese Calcio,4,41,12,34,22
2011,24,Inter,5,36,4,34,30
2011,24,AS Roma,6,35,9,36,27
2011,24,SSC Napoli,7,34,14,38,24
2011,24,US Palermo,8,31,-1,33,34
2011,24,Catania,9,31,-1,28,29
2011,24,Cagliari Calcio,10,30,-2,22,24
2011,24,Genoa,11,30,-12,31,43
2011,24,Fiorentina,12,29,2,25,23
2011,24,Parma,13,29,-7,29,36
2011,24,Atalanta,14,27,-1,26,27
2011,24,Chievo Verona,15,27,-11,19,30
2011,24,Bologna,16,26,-6,21,27
2011,24,Siena,17,23,-1,22,23
2011,24,Lecce,18,18,-16,22,38
2011,24,Cesena,19,17,-19,15,34
2011,24,Novara,20,16,-22,20,42
2011,25,AC Milan,1,50,27,48,21
2011,25,Juventus,2,50,22,37,15
2011,25,Udinese Calcio,3,42,12,34,22
2011,25,Lazio,4,42,9,38,29
2011,25,AS Roma,5,38,10,37,27
2011,25,SSC Napoli,6,37,17,41,24
2011,25,Inter,7,36,1,34,33
2011,25,US Palermo,8,34,3,38,35
2011,25,Cagliari Calcio,9,31,-2,22,24
2011,25,Catania,10,31,-3,29,32
2011,25,Chievo Verona,11,30,-10,20,30
2011,25,Genoa,12,30,-13,31,44
2011,25,Fiorentina,13,29,-1,25,26
2011,25,Bologna,14,29,-3,24,27
2011,25,Parma,15,29,-8,29,37
2011,25,Atalanta,16,28,-1,26,27
2011,25,Siena,17,23,-4,23,27
2011,25,Lecce,18,21,-13,26,39
2011,25,Cesena,19,17,-21,16,37
2011,25,Novara,20,17,-22,20,42
2011,26,AC Milan,1,51,27,49,22
2011,26,Juventus,2,51,22,38,16
2011,26,Udinese Calcio,3,45,14,37,23
2011,26,Lazio,4,45,10,39,29
2011,26,SSC Napoli,5,40,18,42,24
2011,26,AS Roma,6,38,7,38,31
2011,26,Inter,7,36,0,34,34
2011,26,US Palermo,8,34,0,39,39
2011,26,Catania,9,34,-1,32,33
2011,26,Chievo Verona,10,33,-9,21,30
2011,26,Atalanta,11,31,2,30,28
2011,26,Cagliari Calcio,12,31,-3,23,26
2011,26,Genoa,13,31,-13,33,46
2011,26,Parma,14,30,-8,31,39
2011,26,Fiorentina,15,29,-2,25,27
2011,26,Bologna,16,29,-5,25,30
2011,26,Siena,17,26,-1,27,28
2011,26,Lecce,18,24,-12,28,40
2011,26,Cesena,19,17,-22,16,38
2011,26,Novara,20,17,-24,21,45
2011,27,AC Milan,1,54,31,53,22
2011,27,Juventus,2,52,22,39,17
2011,27,Lazio,3,48,11,41,30
2011,27,Udinese Calcio,4,46,14,37,23
2011,27,SSC Napoli,5,43,19,44,25
2011,27,AS Roma,6,38,6,39,33
2011,27,Inter,7,37,0,36,36
2011,27,Catania,8,35,-1,34,35
2011,27,US Palermo,9,34,-4,39,43
2011,27,Chievo Verona,10,34,-9,22,31
2011,27,Atalanta,11,32,2,30,28
2011,27,Fiorentina,12,32,0,27,27
2011,27,Bologna,13,32,-4,26,30
2011,27,Genoa,14,32,-13,35,48
2011,27,Cagliari Calcio,15,31,-6,23,29
2011,27,Parma,16,30,-9,32,41
2011,27,Siena,17,29,2,30,28
2011,27,Lecce,18,25,-12,30,42
2011,27,Cesena,19,17,-24,16,40
2011,27,Novara,20,17,-25,21,46
2011,28,AC Milan,1,57,33,55,22
2011,28,Juventus,2,53,22,39,17
2011,28,Lazio,3,48,9,42,33
2011,28,SSC Napoli,4,46,22,50,28
2011,28,Udinese Calcio,5,46,13,37,24
2011,28,AS Roma,6,41,7,40,33
2011,28,Inter,7,40,2,38,36
2011,28,Catania,8,38,0,35,35
2011,28,Bologna,9,35,-2,29,31
2011,28,US Palermo,10,34,-5,39,44
2011,28,Chievo Verona,11,34,-11,22,33
2011,28,Atalanta,12,33,2,31,29
2011,28,Genoa,13,33,-13,35,48
2011,28,Siena,14,32,4,32,28
2011,28,Fiorentina,15,32,-1,27,28
2011,28,Parma,16,31,-9,33,42
2011,28,Cagliari Calcio,17,31,-9,26,35
2011,28,Lecce,18,25,-14,30,44
2011,28,Novara,19,20,-24,22,46
2011,28,Cesena,20,17,-26,16,42
2011,29,AC Milan,1,60,35,57,22
2011,29,Juventus,2,56,27,44,17
2011,29,Lazio,3,48,8,42,34
2011,29,SSC Napoli,4,47,22,52,30
2011,29,Udinese Calcio,5,47,13,39,26
2011,29,AS Roma,6,44,8,41,33
2011,29,Inter,7,41,2,38,36
2011,29,Catania,8,41,1,36,35
2011,29,Bologna,9,36,-2,31,33
2011,29,US Palermo,10,35,-5,40,45
2011,29,Chievo Verona,11,35,-11,24,35
2011,29,Atalanta,12,34,2,31,29
2011,29,Cagliari Calcio,13,34,-6,29,35
2011,29,Genoa,14,33,-14,35,49
2011,29,Siena,15,32,2,32,30
2011,29,Fiorentina,16,32,-6,27,33
2011,29,Parma,17,31,-11,33,44
2011,29,Lecce,18,26,-14,31,45
2011,29,Novara,19,23,-22,24,46
2011,29,Cesena,20,17,-29,16,45
2011,30,AC Milan,1,63,36,59,23
2011,30,Juventus,2,59,29,46,17
2011,30,Lazio,3,51,9,43,34
2011,30,SSC Napoli,4,48,22,54,32
2011,30,Udinese Calcio,5,48,13,40,27
2011,30,AS Roma,6,44,7,42,35
2011,30,Catania,7,42,1,38,37
2011,30,Inter,8,41,0,38,38
2011,30,Atalanta,9,37,4,33,29
2011,30,Bologna,10,36,-4,31,35
2011,30,US Palermo,11,36,-5,41,46
2011,30,Chievo Verona,12,36,-11,25,36
2011,30,Cagliari Calcio,13,34,-7,29,36
2011,30,Genoa,14,34,-14,37,51
2011,30,Siena,15,33,2,33,31
2011,30,Fiorentina,16,33,-6,29,35
2011,30,Parma,17,32,-11,35,46
2011,30,Lecce,18,27,-14,31,45
2011,30,Novara,19,24,-22,24,46
2011,30,Cesena,20,18,-29,18,47
2011,31,AC Milan,1,64,36,60,24
2011,31,Juventus,2,62,32,49,17
2011,31,Lazio,3,51,7,44,37
2011,31,SSC Napoli,4,48,19,54,35
2011,31,Udinese Calcio,5,48,12,40,28
2011,31,AS Roma,6,47,10,47,37
2011,31,Inter,7,44,1,43,42
2011,31,Catania,8,43,1,39,38
2011,31,US Palermo,9,39,-3,44,47
2011,31,Chievo Verona,10,39,-10,27,37
2011,31,Atalanta,11,37,2,33,31
2011,31,Cagliari Calcio,12,37,-5,31,36
2011,31,Siena,13,36,3,34,31
2011,31,Bologna,14,36,-6,32,38
2011,31,Parma,15,35,-9,38,47
2011,31,Genoa,16,34,-15,41,56
2011,31,Fiorentina,17,33,-7,30,37
2011,31,Lecce,18,28,-14,31,45
2011,31,Novara,19,24,-25,26,51
2011,31,Cesena,20,19,-29,18,47
2011,32,Juventus,1,65,34,51,17
2011,32,AC Milan,2,64,35,61,26
2011,32,Lazio,3,54,9,47,38
2011,32,Udinese Calcio,4,51,14,43,29
2011,32,SSC Napoli,5,48,17,55,38
2011,32,AS Roma,6,47,8,49,41
2011,32,Inter,7,45,1,45,44
2011,32,Catania,8,43,0,41,41
2011,32,Chievo Verona,9,42,-9,30,39
2011,32,Siena,10,39,4,36,32
2011,32,US Palermo,11,39,-5,44,49
2011,32,Cagliari Calcio,12,38,-5,33,38
2011,32,Atalanta,13,37,1,34,33
2011,32,Bologna,14,37,-6,32,38
2011,32,Fiorentina,15,36,-6,32,38
2011,32,Parma,16,35,-11,39,50
2011,32,Genoa,17,35,-15,42,57
2011,32,Lecce,18,31,-12,35,47
2011,32,Novara,19,25,-25,27,52
2011,32,Cesena,20,20,-29,18,47
2011,33,Juventus,1,68,35,53,18
2011,33,AC Milan,2,67,36,62,26
2011,33,Lazio,3,54,8,48,40
2011,33,Udinese Calcio,4,51,12,44,32
2011,33,AS Roma,5,50,10,52,42
2011,33,SSC Napoli,6,48,15,56,41
2011,33,Inter,7,48,2,47,45
2011,33,Catania,8,43,-1,42,43
2011,33,Chievo Verona,9,42,-10,30,40
2011,33,Atalanta,10,40,3,37,34
2011,33,US Palermo,11,40,-5,44,49
2011,33,Bologna,12,40,-5,33,38
2011,33,Siena,13,39,3,37,34
2011,33,Cagliari Calcio,14,38,-6,33,39
2011,33,Parma,15,38,-9,41,50
2011,33,Fiorentina,16,37,-6,32,38
2011,33,Genoa,17,36,-15,43,58
2011,33,Lecce,18,34,-11,37,48
2011,33,Novara,19,25,-27,27,54
2011,33,Cesena,20,21,-29,19,48
2011,34,Juventus,1,71,36,54,18
2011,34,AC Milan,2,70,37,63,26
2011,34,Lazio,3,54,7,49,42
2011,34,SSC Napoli,4,51,17,58,41
2011,34,Udinese Calcio,5,51,10,45,35
2011,34,Inter,6,51,4,50,46
2011,34,AS Roma,7,50,9,53,44
2011,34,Atalanta,8,43,4,38,34
2011,34,Catania,9,43,-4,42,46
2011,34,Chievo Verona,10,42,-11,30,41
2011,34,Cagliari Calcio,11,41,-3,36,39
2011,34,Bologna,12,41,-5,34,39
2011,34,Parma,13,41,-8,43,51
2011,34,Siena,14,40,3,38,35
2011,34,Fiorentina,15,40,-5,34,39
2011,34,US Palermo,16,40,-6,45,51
2011,34,Genoa,17,36,-16,43,59
2011,34,Lecce,18,34,-13,37,50
2011,34,Novara,19,28,-26,29,55
2011,34,Cesena,20,21,-30,19,49
2011,35,Juventus,1,74,40,58,18
2011,35,AC Milan,2,71,37,64,27
2011,35,Lazio,3,55,7,50,43
2011,35,SSC Napoli,4,54,19,60,41
2011,35,Udinese Calcio,5,52,10,45,35
2011,35,Inter,6,52,4,50,46
2011,35,AS Roma,7,50,5,53,48
2011,35,Catania,8,46,-2,44,46
2011,35,Parma,9,44,-5,46,51
2011,35,Siena,10,43,6,42,36
2011,35,Atalanta,11,43,2,38,36
2011,35,Chievo Verona,12,43,-11,30,41
2011,35,Bologna,13,42,-5,35,40
2011,35,Fiorentina,14,41,-5,34,39
2011,35,US Palermo,15,41,-6,47,53
2011,35,Cagliari Calcio,16,41,-6,36,42
2011,35,Genoa,17,36,-19,44,63
2011,35,Lecce,18,35,-13,38,51
2011,35,Novara,19,28,-28,29,57
2011,35,Cesena,20,22,-30,21,51
2011,36,Juventus,1,77,44,62,18
2011,36,AC Milan,2,74,40,68,28
2011,36,SSC Napoli,3,55,19,62,43
2011,36,Udinese Calcio,4,55,12,47,35
2011,36,Inter,5,55,5,52,47
2011,36,Lazio,6,55,5,50,45
2011,36,AS Roma,7,51,5,55,50
2011,36,Catania,8,47,-2,45,47
2011,36,Parma,9,47,-4,48,52
2011,36,Atalanta,10,46,4,40,36
2011,36,Bologna,11,45,-4,38,42
2011,36,Chievo Verona,12,44,-11,30,41
2011,36,Siena,13,43,3,43,40
2011,36,US Palermo,14,42,-6,48,54
2011,36,Cagliari Calcio,15,42,-6,36,42
2011,36,Fiorentina,16,41,-7,34,41
2011,36,Genoa,17,36,-20,46,66
2011,36,Lecce,18,35,-14,39,53
2011,36,Novara,19,28,-32,29,61
2011,36,Cesena,20,22,-31,22,53
2011,37,Juventus,1,78,44,63,19
2011,37,AC Milan,2,77,42,70,28
2011,37,SSC Napoli,3,58,21,64,43
2011,37,Udinese Calcio,4,58,13,48,35
2011,37,Lazio,5,56,5,51,46
2011,37,Inter,6,55,3,53,50
2011,37,AS Roma,7,52,5,55,50
2011,37,Parma,8,50,-2,51,53
2011,37,Bologna,9,48,-3,39,42
2011,37,Catania,10,47,-3,45,48
2011,37,Atalanta,11,46,2,40,38
2011,37,Chievo Verona,12,45,-11,30,41
2011,37,Siena,13,44,3,44,41
2011,37,Cagliari Calcio,14,42,-7,37,44
2011,37,Fiorentina,15,42,-7,36,43
2011,37,US Palermo,16,42,-8,48,56
2011,37,Genoa,17,39,-19,48,67
2011,37,Lecce,18,36,-14,40,54
2011,37,Novara,19,29,-32,31,63
2011,37,Cesena,20,22,-32,22,54
2011,38,Juventus,1,81,46,65,19
2011,38,AC Milan,2,77,40,72,32
2011,38,Udinese Calcio,3,61,15,50,35
2011,38,Lazio,4,59,7,53,46
2011,38,SSC Napoli,5,58,19,64,45
2011,38,Inter,6,58,5,57,52
2011,38,AS Roma,7,53,5,57,52
2011,38,Parma,8,53,0,53,53
2011,38,Bologna,9,51,-1,41,42
2011,38,Catania,10,48,-3,47,50
2011,38,Atalanta,11,46,0,40,40
2011,38,Chievo Verona,12,46,-11,34,45
2011,38,Fiorentina,13,45,-6,37,43
2011,38,Siena,14,44,1,44,43
2011,38,US Palermo,15,43,-8,52,60
2011,38,Cagliari Calcio,16,42,-9,37,46
2011,38,Genoa,17,39,-21,48,69
2011,38,Lecce,18,36,-15,40,55
2011,38,Novara,19,32,-29,34,63
2011,38,Cesena,20,22,-35,22,57
2011,39,Juventus,1,84,48,68,20
2011,39,AC Milan,2,80,41,74,33
2011,39,Udinese Calcio,3,64,17,52,35
2011,39,Lazio,4,62,9,56,47
2011,39,SSC Napoli,5,61,20,66,46
2011,39,Inter,6,58,3,58,55
2011,39,AS Roma,7,56,6,60,54
2011,39,Parma,8,56,1,54,53
2011,39,Bologna,9,51,-2,41,43
2011,39,Chievo Verona,10,49,-10,35,45
2011,39,Catania,11,48,-5,47,52
2011,39,Atalanta,12,46,-2,41,43
2011,39,Fiorentina,13,46,-6,37,43
2011,39,Siena,14,44,0,45,45
2011,39,Cagliari Calcio,15,43,-9,37,46
2011,39,US Palermo,16,43,-10,52,62
2011,39,Genoa,17,42,-19,50,69
2011,39,Lecce,18,36,-16,40,56
2011,39,Novara,19,32,-30,35,65
2011,39,Cesena,20,22,-36,24,60
